------T?E-T--M--------------?E----XE-------------------E?X-M---M-----?-------?B-----E-----Xo---------------?--?--------X----M-----E---?----B------T-M------XB---o-----------------X----------o?---------
----X-M-o-|--------------oX--BB---------?--X--------?B--------------o----o---------------?-------------------?X-----------X-T-o---X-----E----M----M-----X----------X------o-B--o------M--M-------B----o-
--E-------?----?---Mo----B-T-----o--B---------B--M-X---------------B-?----------------o--?----------------T---------------X-X-----E--M------?---?-------------M----------B---------------X-------B------
-B--B-----------B----------?--X-----E-E-T-----B--?-E------?-------?----------M-----------?-------T---M----?-----T--------------------------o--M-T?---M--M------E-----T----------X-B?-----?--?---?E--X?--
---?-MX?-------M-----??-------T-----XM--X------?--?-X-----B-------?X-M-----------B------B---B--E-M-----------B--X---XB-----?-M-----?------------X------B-o--------X--?----B---?----------?-M-B------o---
--M-----M-X-B--o------M--?-------B----------M----o--E--------------M------?--M--B------------M-BoE---?-X-------------E------o?X--------?---X------T------E---EB------o-----M----E-B---------X-------?---
----?---?--------oM-------------------------E---------?-----X-----E-------Bo---X-T---------o-E-----MX----X--------------------o---B---------------M-------------M----B-------BE-------o-X----oXE------T-
---M-o---------E---B------?---T-------B--------?--E---------X--------M--------M-M?-----X-M--E---X------M---------X---M------------oB---------------------------X---E---------o?--T--B----------BM-----Xv
------T-------o---------------XB?------B--------X-o-------------?------T---------------------XEX------B------X------oo-----------?------X--E--E-B---------B-MX-E-?-----BE------T-B?-oM---------TX-X----f
-EX---|----------o-----?---X----T--------B----------EE-----------------?E---oE---M--------?--o-------------------------------M----B-----------E-------------M--M--o-TMMB---o---?-X----o--------M---?---f
---E--X------X----T--------?----X-B--------------?-------E--------E------E---o------------M-o-T--------E----?------------------------B-----------------------T-B----M----M------------Bo---------B---X-f
---------------E--M---E-------------------M-?--?-------B---T--?-----B---B----B--B--X----?---B-?----X---o---------------------o------------o--E--BM-----X-----X--E----------B--T------E-B------E--------f
---EBB-T-?--?---------------------T----------------oM----X-M-----X----------X-------------------------B---------MB--------E--oo----M---------T-------------------o-?--o------?X----o--T----------------f
-------|--------T-----XE---B------B---B--B-------------X-B--------------------M-----------o--B-----?--E------------XX--?-B--T-----X----------B----------X------o------?--?------------X----?-----------f
m-TX---?--------B------X-E--M--X--X--------MoXM--T--------------B---XT-X-Mo------------T----E-B---o-T----o----?---------TM--B-----M---X----------T---B-------------------M---T-----------B---B-o-----X-X
XXXXXXXXXXXXXXXXXXXXXXXXXXXXXXXXXXXXXXXXXXXXXXXXXXXXXXXXXXXXXXXXXXXXXXXXXXXXXXXXXXXXXXXXXXXXXXXXXXXXXXXXXXXXXXXXXXXXXXXXXXXXXXXXXXXXXXXXXXXXXXXXXXXXXXXXXXXXXXXXXXXXXXXXXXXXXXXXXXXXXXXXXXXXXXXX--XX-XXX
