----M----E|--?-TX------|X-?o---M--M|E-?----B--T---E?-T--E-E---------o-TT|MB--oXT?MMB----T----|M--TM---X-E?-E-----|---XM?--B-o--M-BT--|-------|--|--M--?-?BM--T---XBM-M--|-B-XE-MX--?--X-B-o-------X-|E--
------XX--EB-T-----?T--o-o---?|--oo|-T-?-?X-T--|--|-----Bo-|--T-|---|BE-o-E|--?---E---X-|o-T-X-?-TE--M---------BB|-ME-B---o-T-|M-E--|-T---oo-T-Mo--T|XMEE-----E-Bo-M--B---o--XX-T--E-o?-BMM-To------|---
--------EEX-?-B-------T|--XM-?B--T|------o-B-X--X--T---|X--XE-Eo---------o----------?--B------|T-MT?-----------M---|----M-oB---ME-o--?-o-BT--MX-o----o?MB---E--|o--o-|--T--?-M--B?E-TT-----T--?oE--X--E-
-MT-?oT--TXBM--M---TXB-XME-M-?-M---|X-E-?M-----?o-?oB?M--X-------|o---BE-|EE-B-?--E??BM-ToM--Eo--BB--M--o-----E--?--E-B-----TM-TEX--BEo---B----|--T-Moo--T?--M----X---||-B--TEBT-B?-E|--X------o---X-B|-
---||Bo-------E--|---B--ME-------B--BB-Mo------EE-X|--MT-B--Bo--XX|-To-MT---?M----B--?o-E--T-oXX-T---M--BT-?-M?M----------M--oo-E-|------oT?o---o----M--?M--XBM--B-Bo----M-?----oXXM-M|--oo--X-o-M|oXTo-
---XT-|-M?|-----E--E?---?B-o-?T|||-oB-T?-M------o-oE-X--?--T--E-BE-E--|-o--MM-T-E--Mo-T---B--X|oX-oXEX-Bo----M?-|B----M|o|oXT-T------?To-TBXBX-X---|T-o|--M--MoX|BMT?---MoXX--TME-ET-oM-?B??T-?M--BT?---
--oM----?B--E---MEoMTT-------o--?E-o-----|----XBX---B-X-EB-T-|B-o---X-B?----ET-E--MB|-XT-o-M--BE--o--|-----T|-B|--?M--|-?-?X--EXT-EX?----MoB--o--M?X----B--T-X-----EXM-------BX--------XT-EM|--|X---BMB-
--o-M----o-M-M---B--M-TE----o?B-E-EMTXTX-|-?---TE---o--?--|T--------?|-M-----|--|--oT-o-B--E-o--X-BT?-|T---X---E?XX?oX-o-B---|-E-|Bo--?----MM-oE--TooM?B--E---TTBMo--EB-XMTo-|-TX--o?----E----EE?-B?--ov
-?-T--T-TMT--o-EX--B-----?-BM--oE---MB?X--|B-E-T|XX--X--|----M--|T?M-XTB-E?-------T--MM-|-----E?TTE---TMT-T-|-B--E|-T--?-M-|X--BX-B-M----o--|?E----?---E-T--?T-M--?|---MXX-M--B---BB-E--X------X-o-M||-f
-M---X----TM-o?M----B--o--oo---T-o-o--|--BT---o-TBXEEME--M-----TEo-------EE--T--Mo-M|-----TE----MX?To--M?-BT---o-o?-T-|-X-T--|---|BEBM?--?--XM-X|-o---o--XM---E-E-XXM---T---X-?-?-o|-?T|X---X-?-E---M-of
-oo-?-----E-MT--EXMTMBMo----TE--|E--?---T--T---M---X--?-T-M-|B-MoX-BME-----|---X--?-|T|----EXXE-o-?T|-EM-X---o--|-B--EX|-MX?TX--TBEE-XEB|-oM----M---?---XEXM-----|-EMB--o-E-EBTMBM-----M--?-X----X-X--Mf
----TE-----T-M----X-B-TMo-X---ME-o--M-B-?|-XX--MTM?-XMMT-B-TB|-?---|o-MMBoM--X--X--?o---oX----o-B?-|-B--MM-B-M--o-M-?---o-o|----B-E---------------B----X-E-X-M-M-------ME-EB---|--BE--MB-X-----E|-o---Xf
-?---E-T--Mo|---M---X---E-B--X?-----------M-TXE-oE----E-TEo------T--EB--MX---B--BXM?---o-X-?-o-BM---B?B-XB-o-B-TX-TE--BT--E-E-o--|--X-ME---?T-oEE--EE|---|--E--MT----M--BB-|oT-XX|------XM--EM----T?E?-f
-----TT--?-XXT-o|---BM--Eo-B--M---B-ME-B---M--TEoM--BX---E-----E-TE-X|-B-TTEM?|-o-----M--?---X-TM-----X-TBTB--XBXXMMM|M-ME-M?---T-To-o-?--E-?X-?E-MT---X|--ET?X-MXo--B---?--o-B-M-TT?---X-oT--XX------Xf
m-??T-B-?--ME?-B---MMT-To--|-X-?B-------?----XX--o-o--Xo-|------|-?|M---T|X--Mo-T-B---ME-oE--T-?-?---T-o?-T-----|-------||--MT-o---BoXToTXo?E|---B--BEoX-|--||-o-T-|-|E-?BE--T----B----E---T?-----XBT?-X
XXXXXXXXXXXXXXXXXXXXXXXXXXXXXXXXXXXXXXXXXXXXXXXXXXXXXXXXXXXXXXXXXXXXXXXXXXXXXXX-XXXXXXXXXXXXXXXXXXXXXXXXXXXXXXXXXXXXXXXXXXXXXXXXXXXXXXXXXXXX-XXXXXXXXXXX-XXXXXXXXXXXXXXXXXXXXXXXXXXXXXXXXXXXXXX-XXXXXXXX
