-MBXo|BX?o?XoXEEMo?BB-E|o?-?EXEMBXoX-|oTM?XoT|-X?|B-MoE-?-?|B|BoXM|XBE|??o|oooXoTEoT-?MBBEMEB|Bo|oX?EBXoEBBMEXo-M|oX?XE--BT|T|XM?B|MXM-XoMXE-BE-oX?XBMBoB|?-?B-o?T-MB?EE?EXT?BMMo-XB-EMBXTo?|EB?-oB-E-oM
oEM-X|o|B||-E-B|-|E|M|T||||-XT||EBEB?|||ETT-||T|||oT?X|||o||o|BE-||T|?|||o|B-|XE||||||B?|B|T-|TM|--XEM|ToE||MEEo||Eo?||Bo?|||||BM-|M|EX||BoB|T|-E|M?Bo|oE|BTXMT|E|o|M-|E-B?|Bo|X||M-|T?M?|EE|||-T|?T?|TB
?E||T|M|||||-MX|X||||||||||||||||XEE||||B||B|||||||||T||||||X|B||||||-|||||X||?||||||||||||||||-||-B|||||E||XM||||M||||M|E||||||E?|||BX|||XB|||MM||||X|-||||o|||-|X||||X|TM||||||||M||X-o||?||||||B||||B
E|||||B|||||-|||||||||||||||||||||||||||||||||||||||||||||||||-||||||||||||M||T||||||||||||||||||||T||||||||||||||-|||||||||||||||||||B|||--|||||||||T||||||o|||o|X||||||||||||||||||||To|||||||||E||||?
X|||||M|||||M|||||||||||||||||||||||||||||||||||||||||||||||||?||||||||||||X|||||||||||||||||||||||||||||||||||||||||||||||||||||||||||||||T||||||||||||||||||||||B||||||||||||||||||||||||||||||||||||B
o||||||||||||||||||||||||||||||||||||||||||||||||||||||||||||||||||||||||||||||||||||||||||||||||||||||||||||||||||||||||||||||||||||||||||||||||||||||||||||||||||||||||||||||||||||||||||||||||||||||X
X||||||||||||||||||||||||||||||||||||||||||||||||||||||||||||||||||||||||||||||||||||||||||||||||||||||||||||||||||||||||||||||||||||||||||||||||||||||||||||||||||||||||||||||||||||||||||||||||||||||E
B||||||||||||||||||||||||||||||||||||||||||||||||||||||||||||||||||||||||||||||||||||||||||||||||||||||||||||||||||||||||||||||||||||||||||||||||||||||||||||||||||||||||||||||||||||||||||||||||||||||v
E||||||||||||||||||||||||||||||||||||||||||||||||||||||||||||||||||||||||||||||||||||||||||||||||||||||||||||||||||||||||||||||||||||||||||||||||||||||||||||||||||||||||||||||||||||||||||||||||||||||T
T||||||||||||||||||||||||||||||||||||||||||||||||||||||||||||||||||||||||||||||||||||||||||||||||||||||||||||||||||||||||||||||||||||||||||||||||||||||||||||||||||||||||||||||||||||||||||||||||||||||X
?||||||||||||||||||||||||||||||||||||||||||||||||||||||||||||||||||||||||||||||||||||||||||||||||||||||||||||||||||||||||||||||||||||||||||||||||||||||||||||||||||||||||||||||||||||||||||||||||||||||E
B||||||||||||||||||||||||||||||||||||||||||||||||||||||||||||||||||||||||||||||||||||||||||||||||||||||||||||||||||||||||||||||||||||||||||||||||||||||||||||||||||||||||||||||||||||||||||||||||||||||-
o||||||||||||||||||||||||||||||||||||||||||||||||||||||||||||||||||||||||||||||||||||||||||||||||||||||||||||||||||||||||||||||||||||||||||||||||||||||||||||||||||||||||||||||||||||||||||||||||||||||?
X||||||||||||||||||||||||||||||||||||||||||||||||||||||||||||||||||||||||||||||||||||||||||||||||||||||||||||||||||||||||||||||||||||||||||||||||||||||||||||||||||||||||||||||||||||||||||||||||||||||?
m||||||||||||||||||||||||||||||||||||||||||||||||||||||||||||||||||||||||||||||||||||||||||||||||||||||||||||||||||||||||||||||||||||||||||||||||||||||||||||||||||||||||||||||||||||||||||||||||||||||M
XXXXXXXXXXXXXXXXXXXXXXXXXXXXXXXXXXXXXXXXXXXXXXXXXXXXXXXXXXXXXXXXXXXXXXXXXXXXXXXXXXXXXXXXXXXXXXXXXXXXXXXXXXXXXXXXXXXX-XXXXXXXXXXXXXXXXXXXXXXXXXXXXXXXXXXXXXXXXXXXXXXXXXXXXXXXXXXXXXXXXXXXXXXXXXXXXXXXXXXX
