--------M------------------------------------------M-----------------------------------?-------------------------------T--------------------------------------------------------------------------------
-----------------------------------------------------M-----------------------------------------o--------------------------------------------------------------------------------------------------------
---------------------------?----------------------------------------------------------------------------------------------------------------------------------------------------------------------------
--------------------------------------------------------------------------------------------------------------------?-----------------------------------------------------------------------------------
-------------------------------------------------------------------------------------------------------------------------------------------------T------------------------------------------------------
----------------------------------------------------------------E--------|----------?---T---------------------------------------|-----------------------------------------------------------------------
------------------------------|---?-------------B-----------------------------------------------------------|--------------E------------------T--------------------|------------------------------------
------B-----------------?----------------------------------------------------------------------|--------|----------------------------------------------------------------------------------------------v
------------------------X----------o-------------------X--------B-------|------T-X---------------------------------------------------------M------X-------E--------------------------------------------f
------------------------------------------------------------------o------------------------------------------------------------------M------------------------|----------------------------------------f
-----T--------------------------------------------------------X-------------------------------------------B-----X----X-----------------------------------------------------------------------X--------Tf
------------------|----X-------------------------B--------T------------------------------------------------------------B--------------------------T---T--------------------------------|----------X----f
-------------------X------------------------------------------------------------------T----o---------------------------------------?-------------------------------------------------------------------f
--------------------------------------|----------------------E----------------------------M------------------------------------------------------------------------------------------------------------f
m-------------------------------------------------------------------------------------------------------------------o----------------o-----------------------------------------------------------------X
XXXXXXXXXXXXXXXXXXXXXXXXXXXXXXXXXXXXXXXXXXXXXXXXXXXXXXXXXXXXXXXXXXXXXXXXXXXXXXX-TXXXXXXXXXXXXXXXXXXXXXXXXXXXBXXXXXXXXXXXX-XXXXXXXXXXXXXXXXXXXXXXXXXXX|XXXXXXXXXXXXXXXXXXXXXXXXXXXXXXXXXX|XXXXXXXXXXXTXXX
