o-XXM?B-?--?--|------|--B?o--o-T?o--------TooXToM-XB--MMoT?--?E-E-MB?MMX---T-------M------?-|E--B---M--M---B-?-----?|XM----M----E-|TE|-B-----oT-E---M----M-E-o?-o----XB-T----?--MT-T-XXBT-?---Moo-XTX-oT
--T-o--?X?|T-|-|-E-M--XT-o----oB?Bo-oE----?|o--E|T-M-|----?-----TBEEXM-----EB-----Bo-?-M|-BBB-B----|X---M-oo--M---|X-o--oEoE-?-M-M---|-Eo-MM----XX----BE---T--M-?T--M|--E---E|----To---Mo--M---|--TB---T
B----EMX|?---MM---oo|E----T--Eoo--E-----T---B---o--?-TTE?-XE---|o-T--B-----X-|T-B-EoB---|M|--X-EBT----|---?---TM-o-T--XE---To-|-BX-----------o---E--|-?|--B----|--E?--Bo-----oM----|B-E-T-o------?---MT?
B-X-----|-M-o--o--?-X--T-X-?-EBX---?-o-M----|MT-------X----T---------E----B--X-?-M?--|o----o---TT---To-X---M-T-o---ETT----Bo------Bo|-B?-B---o?---M--o--?-|MT----X----TX----|---?-T?XEMB-MoMoT-----|M--|
|T?-M-E---?-MM--?--B--o---|X------|---BT-Mo||B-?X--BM?E---T|X---X----|---E-----o----E--E---|--MB--M-----|M----Eo--|M-BX|----oX-TE|T-?|--|-B----o--o--o--X?-oBB-BX-X?-X-----B---XB--|--oo-oM--M-T?-o--E?T
MoE|XE|o-Xo-T--MM-Mo-------B-|M?----|T------oooE--X|-T?---B-|---MT-oBE-?---BM-----o--?-?B-o-?-----?XT-o--XX--|--T-EM----EMXX---o-XX--oMTT|-oM|----EX-M?--E||?------XT-X-BTT-oM-MM|o------X|B--XE-oo-X?-|
?T--XM--XM-|ET-----oMME-XE--EXX----X-E?-?E-o--T?E?|B--o--M-?--?---E---X----|-T-|-M---|-|--o--M-----X----oM----o-------oo---E--o|ME?|-------|----BEE--T-M----M----o-MM-TE---?-----?-XTX?-----XX-TBX|-E---
B---E--X-?X-B---E---B-?-M-E?BETB---E--M--T-----o---|B?--o-B---oX-|X-oTX----?oXBT-o----?T----ME--T-------------T--T|T-T---X|--M-|------o-o--|o|-M---T-----oX-?-B|o--o--?--??-o-ME-T-o--?---?-XToB--o---?v
-?-Too|--?----X---oE---?---X-??---?---o-|?-BE-----M------o--?-EoTo------B|--T--MM-XM|T----X-BB-B-XE---Mo--?---?-EM-X|----E-?E-M-E-E----?||-E-||oEM-XTEM-E-EE-M-TM------M-X---M------|---MT-T|-|--|--|-?E
-------M-X--T-|-|--B??TX---ToEM?-T-MXBX?----TX---E-----B---ETE?-|--o---XMTX--E---o--XEEE---o----?XTM-|?--X--TE-ToBT-?-----X-----T-o|B--------|-X--o-XT-B|---oBXT-------X|-X|--oE?oX--?M-?MoEE-------|B-X
o---oXEToB---?---BMT|M--BX|?|o|T|oX-??|-?MT-T-BE--E-ETE-B--?|XMTMMo-MM-BX--B--T-XX-M--MM-o--T-M---MT-o-E?--EE-||---Xo-?-E-M--|M---o|-E-|?----o--M--o---|oM---oMX---?--------B?--B-X--M|M---M-BT--o--|--|
oE?T-E---MoT-o-T----o-oM---To-E----E-X-T--E-EM-E-T-o---oTE--?-B?X-T?M------XT-BM------------oo|-o-B--X-o|EMXBM--o|---|-ME-E?oBTM?----------X----|B--XX-T----BE--T---?|-|---------X-??-T|T-T--------T-B|T
??--o-E-oM|---------TTo------E?M---E--TT|-----BX?--?E---?M-M?B-MBo--T|-TX-|----o--BB-o-X|T------X--|B-?|-?TEXo--oBM-X---M--|-EM--T-----o---X-X?---TT--|---T--|E--|-?T---o-|-X--o---|oMEM-B-To--M----o?oE
?-B-|XT--TX-----TT?--M-X-EM-|MXE-o--|oMBo-|-XB-B?-T--E----o-E--X-B------X-Xo--M----BT-MX-XE-M-oBXBX-X--?X----M-----ooooX-------?||--|----|-M---B-----|-B-XMB--MEX-?-TB-TB-o-o------|-MMo-----o?-ET---X-X
m-EE-----|--?|E---oEM-oo|?-X?XB-?--T?-MM-M?X--X|E---|-X?-o-E--------EM---T---X--o-o---T---|?TM-??M--MM?--B-TM?|-ooM-Eo-TM--oB|-----|o---T---T?E|-?TM-|-o---T--T--EMM-o-B---BMT--XXEB--BE-XE---EM------M-
XXXXXXXXXXXXXXXXXXXXXXXXXXXXXXXXXXXXXXXXXXXXXXXXXXXXXXXXXXXXXXXXXXXXXXXXXXXXXXXXXTXXXXXXXXXXEXXXXXXXXXXXXXXXXXXXXXXXXXXXXXXXXXXXXXXXEXXXXXXXXXXXXXXXEXXXXXXXXXXXXXXXXXXXXXXXXXXXXXXXXXXXXXXXXXXXXXXXXXXX
