----------o--o-M-----?---M--BEB---?M|oM-E-T-oME--o---X-B---?------?------?--?-----E--X---o---EM-o--?M--?-?-------oo-B-E---?----------B-o-Bo-??B?----M-------o----?-o-----T---o--|-B--M--E-------X|---|--
-o------------XB-----B-TM-------E--X|--M-TMM-E---M--------?M-E?---TMM-o---EB----o---T---T-E---------M----B-------B---B?--M---o--------T-----XBBX---X----?--------M-------X---X-oX------X-Bo-M--EXX---M--
------------E--o---X--o-E-o?T?MT-?--|----XMXX--E-o----B------X-oXM?B-------?-------XX?--M-X----XBB?---T-X-----Bo-----B---XMB--BM----TM|-----o--T--TM--o-?--BB----XB--?-----E--T------M----?------X--M---
-T--TMM---------o--E-----Bo---XB-----BEB-------o-------o---M-Bo-MX--XMMMo-M---X------B----?--XME-EXB--|--EX-B----T-------B--MX-?--X-X-?--------Xo-?-BX-?----------TT-X?--M----X?----?-----E-----T-E-TM--
-|--B---TT-E--X--M-------------oX---------T?--------?--------M-X-??----------o-XXT----E-M--o----E----EBM-----M--BBX--X-M-?---oo---B-M-----------------------?-----|X?--?-B---MTo-X--ME--B-------M---B---
-M-----?MMB---Xo-----Mo-?M--B---M-o-MB-?-XB--XX-----E--o-----M--------o---X-T-o--M-----o----------------X---X---?--MM-----X-oX----M---------E------oT---------M---X-o-???B-B-XB---?--o-B--T--E---T---?--
--?----M-----?-----T------??-BBB---T--XTM?B-EEXT--MX----oX-B-BB---X-o-?--B-oMM---------M----E--?-------T--------------B------T---X-X--X---E-X---o---Xo---?-M-----?---M----T-o---M--X-MoBT-B----MoXX---B-
--B----M--B---M----BX----?B-B-B----|---XTM--E--|-----?--B--Eo-------M?---E---B--B-oX------------?--XE-?B-X-?-o-----?XE--E----M-M--?---o-?----o-T----X-M--o-??----B--------M--BTT-T-----B|-----------M?-v
--EX--------?----------o-Mo---XMM--??-o-?TX-E--M----XM-oEX-MXMMBB---?---BEB-XoXB---XT-------o--M--B-B-oB--o-o-E?M------TMT-M-------XE-o?-----o-X-----E--X-------M?X-T---T-M--TMMBXXE-T-EMMM-----------?f
---?X-X-XB--??-?---?--E-----E---T----o---?-o?-----EM-o---TB-----oB-XB-----X-X-----B-?-B------M--------E--B---Eo--B--B--?-X-----?o-BB---o-M------o--E?XT-o----?------?--MXX-E-?--X----X---TT------BBB---f
----ToX-----M----E--?-------X-X-M-B--?--oE---M?-T--E-----M----B---B--------------M-M---E------o----------T?-----E---M---T--M-M--M---X-XX-------?------M---M---X-X------oM?----B-X-Mo----T|B-B--X---o--Bf
--E-M-------X----EBX?-?-------M---?-XoB---M-E---M--Eo--E----------?EX------?M--T-M---o-TB-----B-----?----M--MM-X-?----T-M----?E-E---------B---oE--E-o-Xo-B--M---?---?--To-oX---B-B-T-T-TXX-X--o--T-?--of
--BX-----X---E?--?M---M-B--M-EM-?-M---XoX-------?T--B------T--B-o------M-------M-------M-M-------o-B------X-X-Xo------?BBXBM----E?--------B-M---MM-E-BT-----oM----o----?--------B--MoB-XT-B------B----Xf
------E--M------?-----X-XM--EB--o----o------?--ME|----B?--oX------o------M-----T-?---------?----X--?----------E-Bo----o----o--o--T-----X-?---------E--|----MXXX-MEE--?----M-B----MM-BE--B-----MB-?-----f
m--T-B-X---oE?--------?-?------o-------------BoE-|--M----X-M-?-o----X?-----B---X-TM----?-----?--?-B-E--X--------B-B--?--E--------B-T--T---B-T-E-o-MBT-MMo-B-TB---X--MBo--oo-ME-X--X---T-B-----E-M---M-XX
XXXXXXXXXXXXXXXXXXXXXXXXXXXXXXXXXXXXXXXXXXXXXXXXXXXXXXXXXXXXXXXXXXXXXXXXXXXXXXXXXXXXXXXXXXXXXXXXXXXXXXXXXXXXXXXXXX-XXXXXXXXXXXXXXXXXXXBXXXXXXXXXXXXXXXXXXXXXXXXXXXXXXXXXXXXXXXXXXXXXXXXXXXXXXXXXXXXXXXXX
