------|----oBEB-?EB---X--TE--X-XX--T-o-T----M---||-oBXE--oE-o---??--------|XT?--|ETo??-?-MM---EX--T?--------B----E--EX------o-?-?EBT--||-X-XME-E--|o-B-E-XM-?|B----B|---MTE|--EEM-XT---Eo------|--M--X--
---EE|ME----T--?BE--?-TX----MB--E-X---E--T-M-T-B-EM-T---o------EM--M-To---M-E-E--M-|MX-?-|-BoX-----B--B?XT--XTX-X-BT-------?E-o|TM--Mo--?M--o-To---B-------oMBBoT------TB---TB---TM--M--E--M|-E----B-|X-
-B-B------B?M----E-XX----B--B--o----E----?-X--MM|oM-o-T--X-X?E----o-B----B|----M--------M?-----Bo---?--M|M-Mo-o-BBBB----B-oMXT----|-|XX---?-B-?---M----o-E-M---|??---B-||EX----|-o----oo----o------X----
-----TX---Eo?-X-|-E-?---B---X------EX-T---o?X|?X-XB|-T-oo-?|B-oXET----ETE--MMXX---E-----T--BX-E|?BXM-|o-----o---------XBBX-X-o-|---T-T-o--M--E-EX----------B--?-BEM--E-MT-|-o?X---EXM?oo-E---EMoo-o-----
-?X--BM-B|T-Bo-o-E-M-?X---MEX-oXXB-X?---M-|E|T---o--B-|B--TE?--------E-?--EToE--|-EEE----T-----|--M-----------M?--?EM-B---M-|ME--EXMo------EB||Eo---M-BX---TT-M---------MT--MTT--o-M|-E-E-TM-|?-M--T|M--
-B-BB---?T---M?--o--E|M-X-E--BMBo-MX-X--X-X---E-??-B--T---?||BX-XX--T-XoE?o---M---B---XB--E--XX--T-E-M?|oo--?XT--T|?----E----T---?o-TM|-E----o-|--E---?M?E-o--X|T--X-X-M-TX---M-EBT-|-B-----------T--X--
-M-?-E|oX----EX?-BB-o-T-X---oo--TEEX--XT--XBE---|--|----?M-|?E---M-----?-o----o---BoM|-E-?---E|--|EBX--M----E-o|--X|--ToEM?M-----M-E-B-|-X--------E-?--E|-||--B------|--EX-B|-?--M-MB--?-XB---M--E-MM---
----|-?o|ETBX-B--?----|MB----M-To-oM-MM--X--|--E--BXM-?M|??T---|B-|-----E--o--M?--T-XE-X-B-?--T-?-EX-M-X-|B---M--|?--XT|---o---Bo-BE-o-TT--oB-----T|B---E-EE--|-M?--B--BB-?-MoXT-E---B-oX--X--B-?-M-M-Tv
-EX---BT--B---o-X?--E----o--?M|X---X-|--|-M---XTE-----?-X|--|o-M--?E-M---oBoo--BT??----|?E-T?|B?-?T?-E-XE---X-----EMTE-?-EX|M-B|-|o----M?-XTEMo---ETB--?-M-?T-T|X|oMB--X?---B-|-?|X--M---EB--E-M---Mo-of
---E--?--M----T-------|-o----E||-Mo---|--X-X--|-X-MTM-?T-BE-E-BX-----B|E|---X-B-?-----E-EB--o-|E-----T--EE-EX-T--o-?------X---T--X-----o----?XM---------TM---E|?E--B--E--X--T-B-?---M|-------B----?o-|Bf
-E----XXX--TET--oM--B--?--?|T-MM---oX?E-XXM-B--ToX?B--EMoEB---M----MTB--?T-TE-E---XT-X-|X-o-B--o--?-|E--X-----B-TM-----M-M-------o-M---|?E-Mo-M--M-----o--|E-oE-EE-T--o?o-|----M--|TX---|---Xo-oX--TT--f
-X-B----B-BE?oo?--EoB---M---|B-o-?----||--|E----?X?--|---?|----TB---XEBT-X--ToB|XM|---M-M-X--??--o--X---X?B---------M--To?o--M----o--EM---?B----E?M-oE----T-MB--oo-TT?BT--X-BTo-M-|-T|o---B|-X-M------Tf
-M--oM|-|EE-E-oM-----MX----X-----EBB-B--T---|-oBXBo||oXET-T--|MM----T?------B?oE--o---X-MM-EX-|-o-BM---TM---oT-TE---E---T--M--E-B-o--T-TMB-|o-E|X----BM-o---TXoB-X----|----oX-XE?----o---E-----X-MX----f
---|-------E------|-o-E-?E-TT-ME-------M-E-B-|------TXE-E-BXT-----BME-?o-Mo-ME-|B--?----oB--?E---|--E-B----M--|----M---?TX--T|T-BXX--------E?-|E?TBo------TM-MB----BMo--ToMXX-|--oM----X---X-|-Eo--?MBXf
mM--M---?-BT|BE---X-o-X-------M---B--B---M?ETBEoM--o|-B-------M--X--E-|EM|ooo-T??--o-T--E---E--X--E---|TB-M-?-|------EE--B-o-E----B|--------T-E--M-E--?M-M-?EXX--o-----??o-?o-|M-E?MM?--?oX--|-M?--||B?X
XXEXXXXXXXXXXXXXXXXXXXXXXXXXXXXXXXXXXXXXXXXXXXXXXXXXXXXXXXXXXXXXXXXXXXXXXXXXXXXXXXXXXXXXXoXXXXXXXXXXXXXXXXXXXXXXXXXXXXXXXX-XXXXXXXXXXXXEXXXXXXXXXXXXXEXXXXXXXXXXXXXXXXXXXXXXXXXXXXXXXXXXXXXXXXXXXXXXX-XX
