--------------------------------------------------------------------------------------------------------------------------------------------------------------------------------------------------------
--------------------------------------------------------------------------------------------------------------------------------------------------------------------------------------------------------
--------------------------------------------------------------------------------------------------------------------------------------------------------------------------------------------------------
----------------------------------------------------------------------------------------------X----------M---B------------------------------------------------------------------------------------------
--------------------------------------------------------------------------------------------------------------------------------------------------------------------------------------------------------
-------------------------------------------------------------------------------------------------------------------------------?---------------------------X--------------------------------------------
----------------XXX--------------------------------------------?------------------------------------------------------------------------------------------XX--------------------------------------------
------------------------?--------------------------------------------M-----------------------------------T---------------------------------------------?-XXX-------------------------------------------v
---------------------------------------------------------------------------------------------------------|----------------------------------------------XXXX-------------------------------------------f
--------------------------------------------------------------------------------X------------------------|---------------X-----------------------------XXXXX-------------------------------------------f
-----------------------------------B---------------?----------------------------------------------T----XX|XXXXX---------XX----------------------------XXXXXX-------------------------------------------f
------------------------????????--------------------------------------------T---------------------|------|-------------XXX---------------------------XXXXXXX-------------------------------------------f
----------------------------------------------------------------------------|-------X-------------|------|------------XXXX------------------?????---XXXXXXXX-------------------------------------------f
-----------------------------o----------------------------------------------|-------XX------------|----X-|-----------XXXXX-------------------------XXXXXXXXX-------------------------T-----------------f
m---------------------------------------------------------------------------|-------XXX------X----|------|----------XXXXXX------------------------XXXXXXXXXX----------------E--------|-----------------X
XXXXXXXXXX--------XXXXXXXXXXXXXXXXXXXXXXXXXXXXXXXXXXXXXXXXXXXXXXXXXXXXXXXXXX|XXXXXXXXXXXXXXXXXXXXX|XXXXXX|XXXXXXXXXXXXXXXXXXX-----XXXXXXXXXX-----XXXXXXXXXXXXXXXXXXXXXXXXXXXXXXXXXXXX|XXXXXXXXXXXXXXXXXX
