-B---X---?B-T-----------------E--?-o---T----|--------B------X--B--X----M--T-----------M---E---o----M----T------o--------M---M----X------------M-----X----------B-----X--o-E--------B---X--E--EE-E---EMB-
-----T----E----|--B-|-----o---M-----------?-ToB-----BE-?-----BX---------E-o-------------------B-----o-----|TB--B-----X-X-X------E------BXT-?--B----B-E---M----o-----------o---M|--------|------?--------
----Eo----|M------------ET----E---|-B-----------------X-MXE-------|EM--BB--M--o----------------o------T----?--|--?--------T?--?---E---------?B----------E--M--M-------?------E-?B--------EM-o----Bo--o--
--?----B----?-|T--X-------B--TE?-B-----?-|-------oE?-o--EX---o----E--o-E------------------o--M----?M---o--------|o-----M-----T------XM--oo-B-----X--TE---|?-M---------------------XM--B---|-----|-------
--B------B--TE--T-|---?----E-------oBE------------T----M----?----B-------E-M-o------------------o------EB|-----o|--E---o------------o----XMT----E--------|------T--TM-------B--------M----------?B---B--
---------o----M--|--------------X---------|-o-----|-----oB--X-X----------ET------X-T?------------E----o---o|o--X--?E|-BEET---|T------------M------------|-|-----oo--T-------E---EM|----?XM--E---E--B-?--
-----E-X-----E-|--B---T------Bo---M---------|----------BXooo------o---EM-----------B?--EB-----o---T-------|-------TT---T-------X---XE---E-----M------XX----X-?--------M-----?-----?------B-E---?-|------
---B--X-?-E------o-E--------Mo---------X-------oX------B-|E-B-X----E-------M----ooM---------X-----|-T-B--------o?------X----X----T----o--M---X--T-|-E-o--B---|---|X-M---?o-E--|?------B--|--?|-M----|-Mv
----T-?--|-------?o--|--oX--------------------M--------o--B---T-----|-X--E--T--------BE-TX----E?|E--X-T?-------T|--X--X?------B---?--E---?--X---?-------M-------X---T---B--o----|--M?X-?-----o-T---?T--f
-----X?M---XM--o--T-B?-T--E----E?-----|--?---XTM-----T----|-o---XBM--?o-T-------To-----------------------T---M|-------X-------?-M------B-BT-----E------|------oM---------BX---MB---X--|-----M-X-E|-----f
---EE-ME---B-------?-----X--E--o-----|-----|---M-------T--?-M--XMoX----BM-o-|-|T-|--?------o|-X--M-M----T?B--X-T-B------X------------------B----?X------X---o----B---|------M-----|-|--T-----T---M-B---f
-?-|T-|--|---------E-----------T--X------M---|----BX?----T------o--T-|-?----XE--------------|-?--B?----?-|-X-----o---Bo------B-E?-?oE---X|-----oM-E-B-o-|-|?BM----T-M--BX-T---o?---|--M---------B-B--M?f
--M--------o-------XT-MM-----E-----------------?E?B-|---T----------E-----M-M---M--------------B-------------T-?M--o--E--o-B----?------B------B|-BX-?---------B--X-o-----|-----X-?-o---?||--T---X--|-M--f
--------E------|---------XB------E--------o-----M?o--------o-T-------------B?o--------??|--XT-----EB-o--M-|MB--------M-----BME---|----M--?-----M----?--?--E-----?--|?B--M--M---E-B--------Xo-M-------?-f
m--------M-----T-M---------------M----|---o------------------------E-|--o------E--|-----?XT-o------------XoX--Eo-|--o--M-B-X--B-??---T?X--M--Bo--E-----Eo--|o------M-M--?B-|--|-|--|-?---?E---X---|-X--X
XXXXXXXTXXXXXXXXXXXXXXXXXXXXXXXXXXXXXTXXXXXXXXXXXXXXXXXXXX?XXXXXXXXXXXXXoXXXXXXXMXXXXXXXXXXXXXXXXXXXXXXXXXXXXXXXXXXXXXXXXoXXXXXXXXXXXXXXXXXXXXXXXXXXXXXXXXXXXXXXXXXXXXXXXXXXXXXXXXXXBXXXXXXXXXXXXXXXXXXX
