T---B-ToE-o--B----B-BoXT---M?----Mo-TBT--E--|-|-|--TX-E-------|---X-X-?X-|--X--T--|---?B-?-------oXXX--BM---BEM--TE--????--|M--X-X---X||-XX|-|-E---E--BMEM-?B-B|B-TXB-BE--T|TT--o-X-?T-o-B-T-X-o----T--o
?-E--MX?--o---B-TMM-?M?--?-TT--|||--X----TE?o--X-X-?--T--M--o-T--|XTo--BXM??X---oB-oT-T--|--E-|oT-----T-B-?T---X?B-o-B-B---E?-X--M--TB--|----|--|-B-ME-?----T-----MET----|E-M-X--?-T--M--B---E---XT?-M|o
?-M-|M?-XoM-?B||?MT-B-----E|----E-M-----BMo---------|-BXB---B|--M---------------o------M-BMMT?TE-B--?--B?M-T---M---B-T-B----------M-o-EM-M---|--E?-|X---E|--E-EM---?XX?--|---?--XTT--|-MM-X--E--|-||E-oT
-X---o-M-X---M-ME-E----TM-T--|M-B?---TBo-M-|M--?XEX-M-M-|-E?--XB---E---TMB?T?-M|E----?---T-M----o-|--Mo----T-----TX---o-|-Eo-o|--XB------X?-E--o?--X-------TXM||-o--BM---|-TM---X-T-T--T--?---X-X|-----X
?-o-o--M|E-o-|-?B-XX-TM-EMMTE-oEM-B---?-------XM-T-?-X-----Mo||o|--E-?--B-TEX-T---?|-M-ME-B?T-EB--|---E----B?----T----o--B-XBX--o--------M--o---o?--XT--X??----M---|-?-B-|----E?-BE-o-B---T?M-?T?E-o---|
MEB-E---M??--M-----|T-E?-EE-T-|-----oETM?oT----|-|EEo|-T--M--------|--?---B-----ME---MEEXMM-M--X?---T--?--o--E-T---ME------T-T?--oT|-M-Bo--B|-Eo-E-BB-XT-T---?XXB--??-|oMoM-o|EoT---BB-BBo-oE----?-Bo-TX
E-o--Eo--o--o---X?M?E-M----T-XE-M-T-B---oX---E--M|------------T-E-?-|--|-?-?---o------M-oX-BBo-|-o-T-XX--BX--TXB-EBoM|-o---B|-|--?-M-TB-|B-----?BB|---o----oo--B--EE|?---MBXM-o-E-T--XM-EB-To-M----XoX-|
|--?B-----|oE-X---T--B-B-?X|-T--T-o?-TM?E-X-ooEEM-------B-T-E--T---o-B|oX--MXT--B-T|--?M--E-EEEEMX---M-|oM--E---M-X--X-----?---Xo|BX----XE?oEBXo-T-------T-M?-MoT---X-TTX-o|B?--M---Bo-?BX---??BB---X--v
EBM?E?-XB--o-o----X-XX---|--X-Xo--?-X--TXT----E||E--T-?E-TB---B--E-|------T---X-E|-|-ME-?--ooX-EX---X----X-o|-B----X--oX-|o-----|BM?B----E-X--o-B----o-------o------B-T-----?-?-?BM-T-oT--TB--------B-M?
M-o-TT--?--B-B----E|-X--E--B--M|---X--B-?E-T-M--X--MTX-X--oB----E--------X-o-o?E-------M--Xo-?X------Xo-T-MT--?-?X|o-o---MX|-T?-|--TT?---E-E--E-o-?----B--|-B?-E--X-T|---E---o|--E-|T---X-B|o--EX|--?|Eo
-?B-E------M-----Mo-----M|BX?----Eo----?-BTMoTM-T-----o--?-ME-------?-oBX-----oX-o---|o--MT------XE?oo-?-M---X--o-M-?|----E-ME---B--?B-XM-M----E|--ET--M--T-EXT--|EoMo-M--M-EX?T-|---B---?--?--E------T|
|-MX-X---XE--ToTX--TX-E|o--B-E-|--EX-X---MEB---TB--TEMM-|?-|BXM--|o-o-----|--X----?-o|M----BE-E----X-T-?X--B--M-----B-BTXE-T--?EE-?----------M?M-To--B-----B----oB--XE--EB----T-M--MBo-----||?------T--M
T-T-oM---MT-B|X---BE------XEX-?|--o?E----|BX-M-oE-?-M--o-E-M-----o|MT-M-o------|--o-M?-E--?--E|-M--o---o---ME--M|---o-|EBBo--------o------E----B---?-XM-XT-----M--?---M--T-o-----o-|----?-T-M|-X-TX--o-M
TXTToEBM---M-ET--o?-----oM----MEE----?|E---BEBB----E-XBo-----o--M--------oTB-T-?E-oX-|---?----EE?E|-oB-T|-B--E------|----EM---MX?----X-B-Mo-T-----X-T-BETM-oXB--M-BM-TT?---M---XE-|XEo----|M---M----|-TT
mB-----?o-MB-------X-T----B-E--T-E--|oM--TE-|T-B---X-------TM-|o|-E----?o-|--M?-BMMTM-?-X-M|---To-----BE?T------------?-M-|-T-|-X?BB--o-M---BE-E-oM---E---|M|-T-XX-------E-o--E---MM----|---Bo----M?-E--
XXXXXXXXXXXXXXXXXXXXXXXXXXXXXXXXXXXXXXXXXXXXXXXXXXXXXXXXXXXXXXXXXXXXXXXXXXXXXXXXXXXXXXXXXXXXXXXXXXXXXXXXXXXXXXXXXXXXXXXXXXXXXXXXXXXXXXXXXXXXXXXXXXXXXXXXXXXXXXXXXXXXXXXXXXXXXXXXXXXXXXXXXXXXXXXXXXXXXXXX
