-----------------------------------T------------------------------------T-----|--------?----------------------------------------------------------------------------------------------------------------
----E-----------------------------------?----------------------------------------------------------------------------------------------M--------------------------------------------------------------T-
--------------------------------------------------------------------------------------T----------------------------------------------o------------------------------------------------------------------
------------------------------------------------o------------------------B-----------------------M------------------------------------------------------------?----------------------T------------------
----------------------------------|-------------------------------------------------------|--------------------------------------------------------------------------------X----------E--------E--------
---------------------------------------------------------?--------------------------------------------------B-------------M-------?---------------------------------------------------------------------
--------------------------X-----------------------------------------------------------------------------------------------------------------------------------------------------------------------------
----------X-------------------------------B--------------------------------------B-----------------------?-------o-------------------------------------------------------------------------------------v
-----T---------------------------------------------B------------------------M-------X---------------------------------------o------------------|-------------------------------------------------------f
---------------------------------------------------E-------------------------------------T?----------|---------------------------?-----|---------------------------------------------------------------f
---------------------------?----------------------------------------------E-----------------B----------------------------------------------B------------------------------------------|-------------o--f
-B----------------------------?---X----------B-M-------B---------------------------------------------------X-------------------------------------------------------------?-----------------------------f
-------------------------------------------------X----------------------------------------------------------------------------------------------------------X-------------------o----------------------f
--------------------------------------------------------------------------------------|------------------X-------------E--------------B-----------------------------------------------B--------?-----?-f
m----------------------M-----------------------------------------------------------------------------------------------M-----------T----MT-----------------------------------------?-------------------X
XXXXXXXXXXXXXXXXXXXXXXXXXXXXXXXXXXXXXXXXXXXXXXXXXXXXXXXXXXXXXXXXXXXXXXXXXXXXXXXXXXXXXXXXXXXXXXXXXXXXXXXXXXXXXXXXXXXXXX?XXXXXXXXXXXXXXXXXXXXXXXXXXXXXXXXXXXXXXXXXXXXX-XXX|XXXXXXXXXXXXXXXXXXXX|XXXXXXXXXX
