-M?-|B?-----||MX---EBXM-|--B-----|M-B-B--B-----------M----E--ME-B-----E----T-XX-----?---E-T--|--BX-EMo-o|---oBXo|M||-X-E----E--EEX--|--M?-|T-oT-B----B|-------T-Xo---|T-X--o-MEET-Mo--oE-E----o-oB-M--X-
--|-M---------------ETE?oX---M--MM|--TX----|B-B-MT---Xo-X---oM|-o-TT--MXE?B---MX-X--|-E-o-MoM?--X--BEB-X---?-X--X---B-BooXX-M---M-T--B|--o-?TTT-EB?-|X|-E---T|BEB-X|-|oMEX-|---?-----B-----M?TE--E--|-|-
----T?---TX?o|E---oMB---|--?T?---M--?--TEX?EXMMB--|X--TM----E-E-?-oE-EBMT--TE--oX-?--?---E-B---EE--?-E-?XM-T-M-M---X-oET?o-|o?--o-|E|B---MX-?----B----|TXBB-|-B|oo?T-MX-oBo|--X---|--M--M-Eo--?--X-?-X--
----XMB-|?X-Mo-o|-o---EM--M--XTXBo-o--o-T--T-ET---B-X--X--XT-T---?E----X--B|BTB-M?M-To|MM-------?-?o-o--M---B--oo-ME|--XTE--?--X-BMM---MM|Mo-o----E--Eo---XB---T-o|E-|-||-X--B-B?M------o--E|-o-M-o-TBo-
-XX-----M-|-o-E-E-M--E-----?---B--XTM-T--E---T-?ME---BX--o--MB-|-o-TTX-|--E-E-?ToM-BTE------X--T?XX-M?ET-o-BETX|-E---M-XME-|-----EB-?T--T--X|-----X|--M---------T-?o-|----?o-M-X-----MEM-X-T|-E--ME|-B|-
-X?E-E---?--X--TXMX-----o-T--?-E-M-B--E?|--o-o-oE-X---Mo-T-??--XB-o-o-MB--X-X---|--E---E-oB|-|E-T??-M|--|?--|ME-B-B---BE-----BB|o-----E-o--oM-B----|-|?--|------Eo-MB-|--------MET--B|--T-B-E---?-B?----
----oE-B-oBo|--o------E|X--T--XM-E-Eo--|--?---EME-o-E--Xo-oT-XX----EMM-X|o----oMMB--M|--TT--E----o--T-------M--T----X-T--TMTM-B|?--|o--BE-|-o|---X-|--M---EMX-----??-----B-|XB--|--M-----E--o--?X-E---X-
--oT--B-T--BM-oMX---BME-M-oX---o--XT--M?----XE-Bo?----M-ME--|--X?TB-E--?MM-o------To-o?---XM?---T--??X-XEE---o?EoT---M--|BT-T-E---?---M-T--EoB-|M-X--XoB-o----BTB-oM-T-------oT--|--?-T--o-|?-X--E||XM-v
--MTM|||-|-?-EB-B|--X-o||MTX-EE-?-----M-?B--T|MM---E-----oT--B?-E--M---TT---------Bo-MMX-----?M--?--o-BEXEM------?-XX-|T---E-XM--?-----T|B--o----oo--------|-|T-o-T-o-oM--T---------?-?--E---M-E-|T-X--f
----?---B-E---||------T---o--X|E-----EBo-T?--------?---oT-T---|-|B-?--M-M-BE--?---o----o---|----EoBE--T-----B---o-MT||XM-?M--X-------T--XT-|----TB--E-?MBX|MoT-------------?--oT-BX-BET---Bo-TT-E--o--Bf
--?-X-BE-------M--MB--B-MTMM------|?---oE|ToTT-----B|-B?M-oET---M-EM---oM--o-BX----o-o----BM??--XXXXB--B-o-M-B--------ET--|?---?B-MTBM----Xo--o-E--|E--XoMo-T|--E---X-X--ME-T-o---M----o---MB|T|-E-Bo-|f
--?--o-X-T?---XXo---o---MTX-X?-o-E?E---?X-ETM-M----E--TB?TX|o?---E--|-|X--TT----TET-E----oX-X--X--B--X-?E---M---M---|--M-||?oBE?o---------o--T--T|o-------T-o------oo--|--X-E--X-?--o-XoTEE------E-|-B-f
-------B|-TE----E----?o||-?MMM---Mo|M-?--E?T--------MEX--BEoB-B-M---T-----?--?-X--B|MT|--T-M-TM-TToo--TEE---M---oBT-----X-T----TMM-|-XBXB----M-|--oM--oE--?|?-?o?MT---E-BB-T-|--o?M|ETE----o--M?-Mo-T--f
--T-oo-----B?-?-------E|-?-oEo-?-EEX------||--M---T-XM--?-|-MMBToM---?|---|-M--oE|-?T-----T-EE------XBB-EM-X--ME--|------TM---?---ET---EoB||E-?Xo-?---M?---X---XE-|?o?M--EE|------ToB----|--?B--ToT-M-Bf
mT-T-B--X--T--------?-X-|XET-E--?M-MX---ME---|||--M-o--o--o-B--EMo------o-?--T-X--To-----E?----?E?-------T--?o--?E--B|XE----B--M-o|---BXMo----Eo-----Mo|-E-T-M-?------T?-E-o?T|-XT---XM-----o-o?o-MT---X
XXXXXXXXXXXXXXXXXXXXXXXXXXXXXXXXXX-XXXXXXXXXXXXXXXXXXXXXXXXXXXXXXXXXXXXXXXXXXXXXXXXXXXXXXXXXXXXXXXXXXXXXXXXXXXXXXXXXXXXXXMXXXXXXXXXMXXXXXXXXXXXXXXXXXXXXXXXXXXXXXXXXXXXXXXXXXXXXXXXXXXXXXXXXXXXXXXXXXXXX
