-oT-M---?E---------M------M---?--B----ET----------M----?----------M--XBE??-Bo--|-E-X-X|T--?------E?--?-----o----E----BT----oo-----?----X|X||----------ooo----EE--B-----------------To?-T|----------?----
----M|----|oX------------M?-T---X--------o-|---E----BB----B---Xo----B?-----X--------|o-----M--o------oX---T-T-------ME---M-------------o-o-B--o--oXT---?----------------o--M-BM---|---X--E--T--oEXEME---
-------oM------?E------------B----XM-----XE-------X-----T-----|X|-------EB-B--B--?----E-?X--|----M||T-BX-|-----------B-----?TE--E-----X------X----?---?MBoE-----E------------oT-----BX|--EoET---E---E?--
--M--?-------?--M---o--|T--MBB-M-------o---o-|T-------T?--E---o-----EM--o---T-X-B--X---M--E---|--M---T-----XEE-E-----------B--T-o--|----?oM-----M----E---?-----M-E--T----Xo-T--X-----M-----oT-----T|?T--
----?T-B?o----X-E--|T--B-ME?-----B---o|--E---|X----|------E-----B----E-T--X-----E?---|--------M--o--o----o?------E---E---B?E------|o-------------Mo----E---T-------T--?X--E?-----T---------|-EM------ME-
-X---------oX-To----E-M---M-M-----M|-|-EB?-----------?-o---E--T----B------?|B--------B----------X--?-E?------B--------M----?------|-??---B---B-BX-o-X-E-X--T---------------------------o-?---o-----|----
----------E----o-oM---------B|BM----------X--|----ToTE---MM-T---T-T-T--X----?EB-?E---T-------X-------?------------------B------X---o----------TT--BE------------oX-------?---X|------B--M-----M---------
-o---T|EM-B--E-----|-----|-------E-----|--oT--B---X----------------E-----X----------TB-oT-M-X-----|------B--?X---X------------TT----BT--?--B-oX|o---E-----M-|o-----B---X|X-|-----------|--------X------v
-X---E?---B-------------M--E-|-E-T--------------X--TX-----------X--------E-----X-?-B-BE-----M-----M---X-E----M----E--------X---|------T-----B----?----M------Xo-o---|XM-----?|-?--E-|--o-TX--M---------f
-----------T---?-MX--o-------------M?-E---E------ETE------?------T-o------XE--E------------X--E-|-T-?--T------o-----X--------M--------E----T-----o---MM--------oE----------B-------o--?-----B--M------of
---M-------|--B--M---------------------E----o-----?---T-o----M-E---o-?-----ME--T-?-M-BM-o-----------|-o-----E-X-M---------M--o----T-T-E------------------o-o-ME---|----------------------B-X-?X-----o--f
----|------E--X-Bo--ToB-----X---oX----T--------------M--?------------X--M---M-----------E---o--------T--------TX--o--TM|----|-------X-----E-TE?-|--------------o---T--X-??----T-E-?---X--?-X|?B--?o--o-f
--------M-------------E------T----|---B--------?-----E----BT---o--E------|-o-X-o----E-X|B-o------T---B----B---?T-----X---M--?E---X---M--|TT--?X---|-o--B------------|--?---------EM-------B--------|---f
----?--?--E---------E---------B---E-MX---E---?-?XEM-----T|---T----M?-------|MB--o-T-oB-----XE-----T-Xo---X|-----T---X-----------?--B---ME-B-----------TM-B-----M-o?----X-E-B----X------T---E-BM------E-f
m-T----o--------E-B----M---------MTM-----------M-|EE--?----------------?||----|-T-----M-T--B--------M----M-MT---|---------TB-XB-----o----o??o------------X|T-B|--?------E--|-----M-------------T--X--oBX
XXXXXXXXXXXXXXXXXXXXXXXXXXXXXXXXXXXXXXXXXXXXXXXXXXXXXXXXXXXXXXXXXXXXXXXXXXXXXXXXXXXXXXXXXXXXXXXXXXXXXXXXXXXXXXXXXXXXXXXXXXXXXXXXXXXXXXXXXXXXXXXXXXXXXXXXXXXXXXXXXXXMXXXX?XXXXXXXXXXXXXXXXXXXXXXXXXXXXXXX
