------------------------------------------------------------------------------------------------------------------------------------------------?-------------------------------------------------------
---------------------------------------------------------------------------------------------------------B----M----------M--------------------------X-------------------o-------------------------------
------------------------------------------------------------------------------------------?----------------------------------------o--------------------------------------------------------------------
-------------------------------------------------------------X------------------------------------------------------------------------------------------------------------------------------o-----------
---------------------------------------------------M----------------o------o--------------------------------------------------------------X--------------------------------------------------X----------
------------------------------------E-------------------------------------------------------?------|-----------o----------------------------------------------------------------------------------------
-------------------------------------------------?---------------------------------------------------------------------------------|---------------------------M-B--------------------------------------
----------X--------------------------------------------T-------------------------B---------------------?---------o---------------------------------------------------------------------o---------------v
------------------------------M--------------------B--------------------------------------T----------------------B-------------------------------------------------o-----------------------------------f
------------------------T-----------B-------------------------------B----------------------?-------------------------------------------------------M---------T---------B-------------------------------f
----------------------?--------------------------------------------------------------------------------------------------------------?------------------------T----------------------------------------f
------------------------------?-----------------------------------------------B----------------------------|---X-------------------------------------M-------------------------------------------------f
------------------------------------------|------B------------B----------------------------------------------------------------------------?--------------------B-o------------------------------------f
-----------------T--------E-----o------------------------o------------------------------------------------------------------------------o------------------------?-----------------X-------------B-----f
m----------------------M-------------------------B--?------------------------------------------------------------------M-------------------------------------------------------------------------------X
XX-XXXXXXX-XXXXXXXXXXXXXXXXXXXXXXXXXXXXXXXXXXXXXXXXXXoXXXXXXXXXXX?XXXXXXXXX|XXXXXXXXXXXXXXXXXXXXXXXXXXX-XXXXXXXXXXXXXXXXTXXXXXXXXXXXXXXXXXXXXXXXXXXXXXXXXXXXXXXXXXXXXXXXXXXXXXXXXXXXXXXXXXXXXXXXXM?XXXXX
