---E------MTBBT-X----X----TMoE?X-------?E-o-??-E--oTT--??-X-M--?-----M----?--B-oB---|B-?-|-------?-o---o--B-o|-X-M---B-----MBX---|EM---X----------o-B----M?-o-T-M-----|---------TE---M?X----X?--o----MX-
-|M--M-----o-?--B--B-B--------o-E-oo--|----|BB-BB-??-?EE-E-T?-MTX---X-|-E--X-T--EM--M-E-MB??------EM-|X----X-E--TB-X||------|-T|--E--E--E-T----B--X|E------B--|--?-To-TEM-M-----E--?---X--?-E?-B--|--|--
-E-?--?----|B--|oBo-|-T|--M--X----------B----T-MM--E--?-B-ME--------------E?XX-?E-|--E-?XM-------?--T-E-?--E---M-E--TM-X-M-o-XM-o--o--o--X-----M-T--oX-o----TB---T|E--X-------------E--------?--E---B?--
-M-TT-----------T----M?o-?M----M-BE?--E----------B--T|E---M-T-E-----------o----E-?---E----BE--E-----?---X----|------------o|--E-|-??--E---M----T-|T|-----|-----X---oX?-----T---B|TX-B-X?-X-XT-----X-o---
-Bo---X-M--EXo----Mo--E-?--o---TEE-------X-------M-|---XT--X----T--B-X---X--|---?-X-?--o------oTM-E--Eo-X----TB---??--o|----E----o-|----T-T--------o-?---EE---X------T-XE-----X--EoXTo-----MM-----------
--?B-B------E-E---o---B-XM---------B?---TT--X--X|?Bo--------------o--X-B---?-M---|---?--------B--M--?T-X---T--XXo---EM-M-EoT---E-?--oE-M-X------MM|BX?-|--XT|----T-X-BMTB---o?-BM--TB----|--------X---|-
-----o--BM-X----TXT-M-B-B---E?-----Xo-X-BM--E------M--------T-M--------oE--|------X--T--MM--?|-oE------o-Bo-X?-?--TB-Xoo-o-?-B----?--?----?M-E--E-TX-o---M-----o-BT---B---M--X-------|X--XE------?-o?---
---o?|EooB-T--X---|-----MX--E--XEB--|-|-------?-T-X-----X--B-M-X-T-MMM----?-T---B-B---M-BTE----X--------M-?T------B|---X|M------------o----B--E-M--EM-o-oE---|BE-o-E---?--X?E--B-?--M|--|-B---BT-|-o-X-v
---o-|o-To-M----|To------o-----?-o---B-BX----------T-?-M----M---o-------------TM---o-----E--M------------M---XM-B--X---------B-E---EM-B|-?-E-|?------M-B?M-?-?-E---T|------B------|?|o-----EE|To---?---f
-MM|-|-?----------T?-oTB--|-------?---B----o-B?----X-o-E------oE|--M-T?---B-|---XM--M-----?o|E----?M-ET--?------E-B-B---E---X---M-MM--ME---o-TB----X---o-MT--MMEo|-?--E-T---o---BX?X------B--T-?o----X-f
-----BB----?-------B----B--XX--M|--EB-----E-------BE-o-BB-----E--E-T|M--------?oT-||o-------BoM-----MB----------?----------To------B?|-|----o-MB---TX---T--M--EE--Xo--?To--?-B-----B----|---E---X--B---f
-o--o------o--?Bo----oB-----X---T---BEBE----?---E--XB---BM-M---M--T-oT-o----------------T-M-ME-?-o----BE-oTEoB?-oBT-E----------M---E-----o---o-M-Eo-?--?-BE-X--T----M----o?o|B--M-T---X------X--oM-|-|-f
---|---o---o-B-?|oM----|---|----T---M--E---B----T-----------oM-----?|BME-T----M------XE-------B-M--E--?---M--X-----T-E?|-BT--TEE----E--------EX-oX-----------T--------T|----M|B-B--o--??--?-X-M-?T--M?|f
--o------BB----------o-------XX-T--M-B--------?-----B--X---T-E---B-?-T-M-M-X--M---X-??-|---B--T---?Bo---ME--E?-E-BM-MMEE??---To-BT-----|X-E-BB|o------E?EMM-E|-oM-M-----o--X-oBM-T-------ET----M|---T--f
m|----o--T------X|-Mo-o----TE--|E---TM-o-----X-----M?--ET-X------?Bo----oo|E--X---|-T-X--oMB-E--?--Eo-|---X---MX|---o-BTM-BE--XT||?---?---o-M--ooE----T-ET-X---o--BMB-o---M----------E?--?XM-X---X-T--TX
XXXXXXXXXXXXXXXXXXXXXXXXXXXXXXXXXXXXXXXXXXXXXXXXXXXXXXXXXXXXXXXXXX-XXXXXXXXXXXXXXXXXXXXXEXXXXXXXXXXXXXXXXXXXXXXXXXXXXXXXXXXXXXXXXXXXXXXXXXXXXXXXXXXXXXXXXXXXXXXXXXXXXXXXXXXMXXXXXXXXXXXXXXXXXXXXXXXXXX-X
