---------------------------------------------------------------------------------------------------------------------------------------------------------------------X-----------------B----------------
---------------------------------------------------------------------------------------------------------------------------------------------------------------?----------------------------------------
---?-----------------B------------------------------------------------------------------------T---------?--------------------------------|------------B-----------------------------------------------o-
----------------------------------------------------------------------------------------------------------------o-----------B-----------------T---------------------------------------------------------
-----------------------o-----------------------T-------------------------M-------------------------------------------------------------E------------------------------------------------------|---------
-----------------------------------------o-------------T-----------------------------------------------------------------------------------T-------M---o------------------------------------E-----------
----------------X----------------------------------------------------------------------------------------------------------------------------------------o----------------------------------------------
-------------------------------?---|-------------------------------------------------------------------------------------------------------B--------------------------------------|--------------------v
-------------------------------------------M--------------------------------------------------------------------------------------------------E------------------------M-------------------------------f
----|--------B----------------------o--------E---------------------------------------------------------------------------------------------------------------------------------------------------------f
-------------------------------------------------------------------------------------------------------------------------------X------------------------------------------B----------------------------f
---------------M--------------------------------------X--M---------------------------------------T---------------------------------M---------------------------------------------------|---------------f
--B------------------------------------------------------------------|------|-----------------------------------------------------------------------------B----E------------X--------------------------f
--------------------------------B----------------------------------------------------------------------------------------------------------------------------------------------------------------------f
m----------------------X-----------------------------------------------------------------------------------------------------------------------------------------------|-------------------------------X
XXXXXXXXXXXXXXXXXXXXXXXXXXXXXXXXXXXXXXXXXXXXXXXXXXXXXXXXXXXXXXXXXXXXXXXXXXXXXXXXXXXXXXXXXXXXXXXXXXXXXXXXXXXXXXXXXMXXXEXXXXXXXXXXXXXXXXXXXXXXXXXXXXXXXXXXXXXXXXXXXXXXXXXXXXXXXXXXXXXXXXXXXXXXXXXXXXXXXXXX
