--------------------------------------------------------------------------------------------------------------------------------------------------------------------------------------------------------
-----------------------------------------------X--------------------------------------------------------------------------------------------------------------------------------------------------------
--------------------------------------------o-----------------------------------------------------------------------------------------------------------------------------------------------------------
--------------o---------------------------------------------------------------------------------------????????--------------------------X--------------------------------------------------X------------
-----------------------------------------M---------?-----------------------------------------------------X----------------------------o---------B-------------------------------------------------------
-------------------------------------------------------------------------------------XXXXX--X-----------------------?-----------------------------------------------------------------------------------
-------------------------------------------------------------------------------------------XX-----------------------------------------------------B----?----------------------------------------o-------
------------------------------------------------------------------------------------?-----XXX---------T--------------------------M---------------------------------------------------------------------v
-----------------------------------------M----------------------------------B------------XXXX---------|------------------------------------------------------------------------------------------------f
-----------------------------------------B----------------o-----------------------------XXXXX---------|---o---------------------------------------------------???????----------------------------------f
----------------------------------------------X------------X-----X---------------------XXXXXX---------|-------------------------------o----------------------------------------------------------------f
---------------------------------------------XX-----------XX-----XX-------------------XXXXXXX---------|------------------------------------------M----------T------------------------------------------f
-------------------------------------------XXXX----------XXX-----XXX-----------------XXXXXXXX--BBBBBB-|-----------------------------------------------------|------------------------------------------f
---------------------------o---------------XXXX---------XXXXX----XXXX---------------XXXXXXXXX---------|-----------------------------------------------------|-------------------------------T----------f
m-----------------------------------------XXXXX--------XXXXX--E--XXXXX-------------XXXXXXXXXX---E----E|-------------------------------------------E-----E---|-E----E---------------------E--|----------X
XXXXXXXXXXXXXXXXXXXXXXXXXXXXX-----XXXXXXXXXXXXXXXXXXXXXXXXXXXXXXXXXXXXXXXXXXXXXXXXXXXXXXXXXXXXXXXXXXXX|XXXXXXXXXXXXX-----XXXXXXXXXXXX-------XXXXXXXXXXXXXXXX|XXXXX------XXXXXXXXXXXXXXXXXXXX|XXXXXXXXXXX
