-E--------MoEE-----M-M-o-o-?-?--B----o-------M?---o?M-M--Xo-oo----EXEM-----BB--M--M----M---B-?----B?---M--------------X?B--MB--XM-----M---B-?-M----M-B--------X?-XE----------B-------?---X-Mo--X?---?-X-
---oXE-oo---X-o------MM---E----B-----?E-B--?E-----E------X??-------E-o----------o?-E----MMooB-M--BXo-?----o--BoB-BE---B---B?-?----E--?--oB?oo--X-M-o--M-----B--M--E--XB---X--E-----o----Eo-M---E--o-----
-------?-?--B--Eo---?Bo-?-----B-------M--?o-E-------o--X?---MM-B---B---o----------?----MXB---o?B----oXE-M----XX-EM------------M------MBMBM--B-----?---XB-o---?--?----M-?o--ME-BX-----------B---M-?---?--
---?--X-M-E--B-M---X-o?-----oo-X-M--E-?-X--?B-------X-X----B-----------o?---?---?---?---------X------------XEB--M-X-------E--X-E------oB-----o-Bo-o-M-------?--M-o----oE--o-?o---EEo--E---o-----MB-?-B--
--M--oX---E-MB-X----B-----B-oE?--o---E---EM---B?--M--M--o---------------?----EEBM----E---Bo------o----X--oo-X--o--M-X---oooBM--o--XB---E-oo-?---E-E---?M-Eo----oo-E-----X-o--o?--B--?XM-Bo--X----E------
-E?X---MB---o----M-M---oBB-------X------E-----------?o--?-------------E----?---X-EB---M----E--o----B-o------B--------?----X-o-------M-?----?----B-B---?----------?-----B-BE-o----?E---X-o?-Mo-X--?B-----
---M-E--B-X--EXE---?M----XBo--Mo-MXEo--EBM--X--E-o-X--o-EE-B----oX-----X--X-B--E-X--X-ME-o-o-?--o---B---B----M---B-EB--E--?B-o-?--o-----ME--ME--?-----XB--?--??-M--X-------X?---------?-BBM-------E-o?--
-X-EB-M-o----M-----EB---X------------E----E-----BME----?M?E-EX---o---?---E--B-B--M-X-----EoM--X-----?MX?----X-Eo?E--X-----B?----E-EEE-X---M-M-M--M--MBBo-?B-M--o?--o-?E---MX----E-Xo-?--X---X-------?-Mv
----BXo--o--o--X----o-?-BoM--B---oB-EE-o----?-B----X-MXMB------o--XB----o-o-B--?--MXoE-----o--------X--E-B-?E--B?-----M-?----E-E-?X-M-M-B-?-?---?X-------?--oMM---?-----?-M-----?-Eo---oo--ME----------f
--o-------o------?---------??--?B-----Xo--o-B--Xo--Bo-o----?-----o---?M-Bo----BX-B-X--XM--ooMX---E--B---M-B--o-o-B------X-E--M---?-BBBM-M----BE-B---B-M---E-----X-EX-?--------------------B--BM--E-?-M-f
--oX--Bo-oM---M-----M-----?---X---EM-X-----M--X-B-B-X-M-E----B---?--B?--MM-X--?ME--?E--X-----M-----B--?--X------------?---??----o---o--M-----M----?-X-o-M------E--XM--B--------?X-----B----X--o?-X-----f
-B-?--?--?-E-X--X-B---ooX-E-B-----B--ooM-M---?---------o------BMX---------EXXoB----XE-M-BMo--------M--EM-E--M---MM------XXMX-M----E??--M--Xo-X-----X--o---oM-E-XX--?-o---??B--oB-Bo---?M--X-M-BMEM--oM-f
--ME--o?--?---B----XXB-oB-MM-----E-o----?-X-?--X--?B-EB--------EX-----B------BM-----MB--?X--?EX-o---?---?-----MMBE--?--o--X-o?---------Bo?-X--X--EB------BE-EB--------o-?-o---o---M---BX-??BE--?BB-B---f
--E----EB-?XBE--B------?-EXX?B--XB-E--------X--X-M--M-XXB--B-------?X--?-XM-EB-o---E?-?X---ME--------MX------MM------E-?-M---o-o-M---M--?-------?E--oM---?----------------o--EMB------X-----B--MX--M-XEf
m-X---------B---MX--Xo--MXo------o--M---EB-----BoX--?---EooXo------M--?---?-B-MEEMo?o?o-----o-o-X-------??X--X---o---BoX----B-----X-----M--X-o-------Mo?-------o--o-o-o-E---B---E--o--o-o--M-?-M-----BMX
XXXXXXXXXXXXMXXXXXXXXXXXXXXXXXXXXXXXXXXXXXXXXXXXXXXXXXXXXXXXXXEXXXXXXXXXXXXXXXXXXXXXXXXXXXXXXXXXXXXXXXXXXXXXXXXXEXXXXXXXXXXXXXXXXXXXXXXXXXXXXXXXXXXXXXXXXXXXXXXXXXXXXXXXXXXXXBXXXXXXXXXXXXXXXXXXXXXXMXXX
