-oT-M----E--|------------||---TEB-TE--ET---M|---T-M-o-B?----M------o----??B--E---E-X|-|TTo----T--E?----o-?To--E?--B---T-----oB---T?------X||-?---------------E---B--?-------E------T-?oTT|-M-E-|--o--T--
-----|--T-----|---M--X---M?-T----o-----E---|-T-------B-M----X-X------?----T-?-B--X-M---E---M--o---MB|o----T-T---M---M--T-M--T-E-|------o-o--------X---------B--?----TXo-o-TM|B-E--|T--X-?EB-T-E-E-EM-?--
--TEo------E---?EB---X----------M-X----E-XE?---------?----|----X-|--B----------o---E||-E-X--|-oX------B?----M-----E?-B--M--?T-------oTX----|-XE-------?----T-----------B-----o---B-o-X----oET---M---E---
---B-?---E-----X------||T|B--BX--------oM-ToE----B-----?XTE---------E-?-o--oT--MB|---------------M--?-----T-EE|E---TT----E-B--T?--||-----oMM----M----E-B--XT----------M--Xoo-TTX-----M-----oT---BB-|--E-
-----T-B?o----X---o|-----M--M---?-----|T-EM--|X--X-|---E---ME---------TT--X--?T--?-E-------B----E-----E---?---EX------o--B-E------|o---BB--------M--XM---B--M--M----X---T---|-----M--E-----|--M-----|---
------B----o-|------E----|M-M--ME-M--------------------------------BM-M--X-|E----X--------------X--?-E?-----MBT-----X-M--?----X--o--??-E--?--B--X-o---E-X--T-----------?T---o|------B---|?--?-------|---
-E---o------E----o-E-o-B--|---B-E-----E---X--|X-----------M-T-|?----T----?------ME-?ET?--M---X--B---|?---T-E---B--?-----B-M-M-|--o-oM---|-----T-------T---------o--B--?--?-X-----------------|-T---?E---
--B--T-------EX--T-----------?---E-o--M---------o-----B--E---------E---------E-M----TB-o--M------E|----o----E-o|--M--E--------T-?---BT-----B----o--B------M--o---?-B---X-X-B-----|E----|----X---X------v
-----T--X------------T-------|--T--ET-----o|-------T--X------------o-----E-M--|X---------o--------M-T-X?E--T?-------?ME------?T|---E-T-oX-E-BX--------M-----?--oo----XM-B-|----E--|B|BBo-TX--M---------f
-o----M-----M----MX-------M--------ME-E-?-------B-TE--------o-----B-------X---E---T---X--T--T-E--M---X-------?oET--------o-MEM--------EoB-------|-----M-E---oX-oE-X--E-T--BB---o-----E----E-Bo--|------f
----ET-----|-B-----M-------?E-?E-TM----E-----------o--T------M-----o-----------X----|B-B-T-X?---X-?-|--|-------|----MB----MB------T------o-----?-----M---oM--ME-o-|B-T----X-B------X-----B---?----M----f
---X-B-----E-E--Bo--To--?|---T?-o?T---------E--------ME--------T------T-M---M--E?M-M--|-E---o----E---X---TT-B---TEoB-TM----?---B-------|--E-TE-M|||----E------E-------E-?M-T---M----?MX--?-X|?B----|---f
--------M----------------E-M-T-E||---EB---MT-----------T-----B--?-o|------M---Xo---EE-XT-----?--ET---B----B----T---B-X--EM--?----X---M--?--?-?--B-|-oB-B|----o----B------oE--XE-?EMo---X--B?---ME---oE-f
-----|-?--E|---XM--------M-E--B-----M--|o-TM-?-?-E----M--|-o|--o|XM------o----|-o---o----M-X---M---XXB--M---B-MMT?X-X|---------B--|B-|oM------MB--|----M--T-------?--E--BE-B--M--B-------E--MBMX--?--E-f
mB-oX--o---T---BETB--------------MT--?--M-B-B---?|-----|X---?--------X-?-|------TXX-T---T------|-o--MMo----M------X-------TB-X------o-----?-o--------B|B--|T-B?-------?-E--|-----M--B----E-??-B---|--oBX
XXXXXXXXXXXXXXXXXXXXXXXXXXXXXXXXXXXXXXXXXXXXXXXXXXXXXXXXXXXXXXXXXXXXXXXXXXXXXXXXXXXXXXXXXXXXXXXXXXoXXXXXXXXXXXXXXXXXXXXXXXXXXXXXXXXXXXXXXXXXXX?XXXXXXXXXXXXXXXXXXXXXXXXXXXXXXXXXXXXXXXXXXXXXXXXXXXXXXXXX
