-MXM-|B|Boo?oXEoM-?BBTETX??B|MEMBX-X?-oTX??oT|XoE|BMEoET--?|BBMoXTXXB-|M??|oM|XBT|oTTXMBBXMXM-Mo|--EEBXoEEBXBXo-M?M|?TMM-BT|-|XM??|MX-XXoM--oBE?oE?-BMMoBX?-?TE-B--MB?EXEE-T?XMMT||B-E-BXTX?|oB?-oB-E-EM
oMM?X|M|B||-E-B||-||-|M|||oM|B|B||E-?TM|ETTo||T|-||?TX-|-B||?|BE-||o-?|X|M||?|XE||||||BMMB|T||TE|o?X-MMTM|X||EEoETo|||XB|E||?||BM-|M|EX|TB?BB||-?|M?Bo|o||ET||?|ETBBM||??B||TB|?|||-B|?MM|TE|o|-T|X-B|?B
?E||T|M||||?-|||||||T||||||||||T|||E||||M|||||||T|||||E||?||X|B?|||||-||||||||?||||||||o|||||||-|E-M|?|||||||M|B||M|||BM|M|||||EEE|||-X||||B||||M|B||X|T||||||||-|X||||X|o|||||-||||o|X-B||?|?|M||Bo||BB
E|||||||||||B||||||||||||||||||||||T|||||||||||||||||||||E||||XT||||||||||||||T||||||||-|||||||-|TX||||||||||||o||X||||||||||||BE||||TB||||-||||||E||T||||||||||E|X|||||||||||||||||?||E|||E||||||E||||?
X|||||||||||M||||||||||||||||||||||||||||||||||||||||||||||||||||||||||||||||||||||||||T||||||||||M||||||||||||||||||||||||||||oo||||||||||B||||||||||||||||||||-|B||||||||||||||||||||||||||||||||||||B
o|||||||||||||||||||||||||||||||||||||||||||||||||||||||||||||||||||||||||||||||||||||||||||||||||B||||||||||||||||||||||||||||X||||||||||||||||||||||||||||||||||T||||||||||||||||||||||||||||||||||||X
X||||||||||||||||||||||||||||||||||||||||||||||||||||||||||||||||||||||||||||||||||||||||||||||||||||||||||||||||||||||||||||||||||||||||||||||||||||||||||||||||||||||||||||||||||||||||||||||||||||||E
B||||||||||||||||||||||||||||||||||||||||||||||||||||||||||||||||||||||||||||||||||||||||||||||||||||||||||||||||||||||||||||||||||||||||||||||||||||||||||||||||||||||||||||||||||||||||||||||||||||||v
E||||||||||||||||||||||||||||||||||||||||||||||||||||||||||||||||||||||||||||||||||||||||||||||||||||||||||||||||||||||||||||||||||||||||||||||||||||||||||||||||||||||||||||||||||||||||||||||||||||||T
T||||||||||||||||||||||||||||||||||||||||||||||||||||||||||||||||||||||||||||||||||||||||||||||||||||||||||||||||||||||||||||||||||||||||||||||||||||||||||||||||||||||||||||||||||||||||||||||||||||||X
?||||||||||||||||||||||||||||||||||||||||||||||||||||||||||||||||||||||||||||||||||||||||||||||||||||||||||||||||||||||||||||||||||||||||||||||||||||||||||||||||||||||||||||||||||||||||||||||||||||||E
B||||||||||||||||||||||||||||||||||||||||||||||||||||||||||||||||||||||||||||||||||||||||||||||||||||||||||||||||||||||||||||||||||||||||||||||||||||||||||||||||||||||||||||||||||||||||||||||||||||||-
o||||||||||||||||||||||||||||||||||||||||||||||||||||||||||||||||||||||||||||||||||||||||||||||||||||||||||||||||||||||||||||||||||||||||||||||||||||||||||||||||||||||||||||||||||||||||||||||||||||||?
X||||||||||||||||||||||||||||||||||||||||||||||||||||||||||||||||||||||||||||||||||||||||||||||||||||||||||||||||||||||||||||||||||||||||||||||||||||||||||||||||||||||||||||||||||||||||||||||||||||||?
m||||||||||||||||||||||||||||||||||||||||||||||||||||||||||||||||||||||||||||||||||||||||||||||||||||||||||||||||||||||||||||||||||||||||||||||||||||||||||||||||||||||||||||||||||||||||||||||||||||||M
XXXXXXXXXXXXXXXXXXXXXXXXXXXXXXXXXXXXXXXXXXXXXXXXXXXXXXXXXXXXXXXXXXXXXXXXXXXXXXXXXXXXXXXXXXXXXXXXXXXXXXXXXXXXXXXXXXXX-XXXXXXXXXXXXXXXXXXXXXXXXXXXXXXXXXXXXXXXXXXXXXXXXXXX-XXXXXXXXXXXXXXXXXXXXXXXXXXXXXXX
