------|----E----------T-X-------M-----------E?--?--ooB------|----E-o-T?--------X----|-----|X------X-|-T--o---M-|--M----?-E---M-M------T-----?---|--B---MTE----------BB--------M--|--E-------------------
------B---|-o---MB--------Eo-|-----E--------|----E--|--------T--?XMM--B----?------X---M|------X-o-E-------E---|T----X-E--XX------------E----Xo-----X-T|---------------B-------M-|T--------o--T---|?---B-
----X----XM|-B------?X-----X--------?----o-----T-----B---|-|---------T--B-----?-M------------E---------X---T-?-o-?-----------T-----o-T------------?o--|X---Mo----E-|----M--------?--MX--TT-B-----B---EX-
-----E-M--E|X------M-----B--EB-----B?--E--E-EX-??---XE---o----X--------B|-?X-----oM--?--?-----------XT-o-----E-T--------------||--TMBE?--------|----M------T---------------E------M-?X---------M----oB--
---------X--E-------?---M--TT-M-------------|----B---MB---MX-------o----EM--?-|-|E--------oM-XM-------------B----------------E--E-|o------M-----o---T----M|-|----M---------B---?-?-E----?--MT---|-----T-
--E-?-o--------B----M-?XB--E-----E|-o|---------------M-oTX----|-B--E---oE--M-E-E--B-T?----X--?-------------?----T--T--MX-E-----------o---BE-EM--E---B---|--E--X-----E----X---X---------XT----B--E----E--
-BX-?EET|X----B---B----T---X--MM----------------X--M-X--|---X-----|-o----------E|--XT----T---------oM|----T--E---------------------X--------------T--------|X-|oE-o-?------|-?---o---------B-o-------X--
--o---X---?---------E----B--T----|---X----E-------||--M-E---E----------XX-------?B-------o----B--|oM-o-T----------T-o---------------?-o-M---E--BM----?--------B---E--------TE------X------M------|-----v
---T----oT------------E---------------------------B---XT---?---XME------T|B---M---------o-XXB---E-----o|------B----X----M---------T----------T----oo-T---M-|---E--o-X-----------EBB--T-----------------f
--M----?o--------|---X-o--|-B------?------M-----------T-?---?-BEM----------BX-T------|?-----?--X----o---B----?E--B---X--o---B-------------?------|o-----X---X|--?---?---o---T-------------E---?-X---T--f
----------XT------MB----X-?BM-B-?----oT------T-E-----------o---o-----E-----B---T--T---?------X---To-o-----|?------------EX-------o---o-------?X??--XX--E------------X------?----------o---M-XT-X-------f
-----ME----?-----|---o---T---B------B--------E---------T-------To-M----?--XM-E|-BBoM-------X---M|---?MMXXMM-o--o--o--?---E-M|-------------o---|--o-T---------M-X-------|-E-B-------E--T---E-BX---X-B---f
------B---T-----------B--B-o------------B----?----o|------X---E------|--?--------?--------B-EoT---B--------|B-----|--B--M-------T------------?---B-E---EE--EE---o-?T------M----------------o-------?---f
--X-o--E|------|T-----o--BT--M-o---M-----X-E-M-----T---------|E--E--oT-XM--------T-o-o---X--E-?-------E--T-----------o-oT---||o---------------EE-MMT|--X-X---B--------|--oE--M--------E---?X--X-?------f
m-oooT-------|---EE----EX--B---B--------M--o--?--E-T-----X-------------|-E||B?-o----M-E-Bo---E------MM--------E-?-----?--M-M-------o---o------B---X-----EX----B--B-o---------X-|--Mo--X-B--B--|M--T----X
XXXXXXEXXXXXXXXXXXXXXXXXXXXXXXXXXXXXXXXXXXXXXXXXXXXXXXXXXXXXXXXXXXXXXXXXXXXXXXXXXXXXXXXXoXXXXXXXXXXXXXXXXXXXXoXXXXXXXXXXXXXXXXXXXXXXXXXXXXXXXXXXXXXXXXXXXXXXXXXXXXXXXXXXXXXXXXXXXXXXXXXXXMXXXXXXXXXXXXXX
