X-|-T------XX--o-T?-?---B|TM--T----M--T?-M-E-o--M-B-E-?-T---E-X--o?--------TX-|----X----XB-?-X---|--MoXT?X-ToX-B|-------XB-M|-|-oT--||---?T-ETT?-T--MM---X---?o-?-X|---oM--M?-------M----E|---|-X-----TT
---B---E--MT-B----E---X---|?--BM-BE--B-o---?|--E---Eo--------E?-EoMB--MM-----X?X|EoB-?-Mo-Bo-o---X-B--TB---ToT--M--X-|o-TTB----------BBB|M-MBo-|---o-o---------B--Boooo-EE-EX---?--B?--B--||--|-T---T--|
?--?-----o--TTE|E---ME|-----X----M--?oTooEE-X-T--|-?--?M-X--T--oo--T-E-oX|-E-----M-oo?--|X--MB|-MEE--------M|-o?-?oEEo-E-o----|-M|Too---oTTB--?|--o------E?---TEo--|----o--M-?---|X---MMM-oEXM---B-M-M?-
?-M-o-T--ET|-T-o--T-BEEXT-M-E?---X-T--|B-MToo-EX-?---T-|E-|E-|TE---||--T|o-XXXB|T-------T-----||T-TTX-?B-T-MB-MX-MT-------?E--X-|M--|M-X--E--B--E?-------?-X--oX--X-oX?---M--TB?M--|MMB---o-oo--T---B-oT
|o?Moo-X----XE-|---BoET|---o-?--o-M-B---?-X-M-MXBXE--B-BB-X--E-M-o?-|-X----oB--BB-----?oE-XE-B---X--TM--M---|MXooMMToBE--TE--X---?MX-o---E---E?MB--M-E--X?|-E-oM-XTMEB---M---B?---TB-MX------X--EE-?---?
?--B--|-oMXo----MX?-?------|-----MT|-TX--MT--?|---XM-o-T?|X-|--TXBo----T-----E--|-|--------|?oM-|--?----?M----o?--?E----M?E-|----B-T-ME|X--o--|B---X--?----M--M-----B--T-TX-----B----o----?MM-E-o|o-|E-M
MXM--To----o--oM---o------oMoX--MX-EM--?---|--BBEB---B-X----o-------T-M-o-B----M-?E||?B-XM-E-?To-MBEo-MEM?---oX-?E---Mo-oTE|B---B-------o?-T-o-BTXM----B----X-oTB-??-MB-EB---??-X----EMBM---X--?-T|ME--|
E-X|T--?-ET---o------??-----M-TX-B-EXT|TTXT-oM------T--|M--M---?-E---B---M-o----EB--B?-|o-----X||---X-B-EM-------M|--BB?|M---T-XM-oXX?o-o-oME?-BMo-ooT----Xo--|-E|---MX--ETM--M-B-----?--BX---B-Xo?-B-Tv
B---T|-TXXB---X---?T-|E--X-XE--|--?---B--E|M|X-o---E--TBTE----To-----?XM---T-----B-BE-EBoTE-o-To-TX-|-M-|E---M-Eo-?MToBMBo?----X----M-------?---|--ME-T-|o----X--|T-T-o-|B|EM--o--T-----BE--T-oTo?--M-|B
-|-M--X-T---?|---B-?o?B-??B-B--o-BMo--o--?--oM---E--oTX-----|---o-?--?M--M-M--------oM-------B---|E?B|--E---XTEo---?-ME|o|----TT-X?E-E--X-?|--E---o-B---o?-----B-?-Xo-T----E---o--------?-ME--M--EX---MB
E-M--|-EBM-|o--MX--T----M--ME---E-M-E?--o---T-|T---B-MET--?--Mo?X|X-X|B-E---X----X|-|--|?-|-|X-BT-E-B-E--M|-B-?-B?----E-ET-MT-??MEo?--|-|-o--TTo--X---|B-?---BX-o-TT---||M-?-o--E-EM----|-MM--|-?|-T|-Mo
oE-X-o----To-----B---|--BT---??----X-EB?---EBE|-MT|T?-?M---|-o-----?-?-------BX----M----?o----BE--X-T-E----M-o--M--T--B-B-E-B-?EBE---|--X-o-oo-T-M---X-T--?-M?X--E--E--?---X-?---Mo-o---TE----?E-X-B-??X
X-----E-Bo---Eo----M|--EMX-Mo------TT-?---------oB-|---?------o?-E-BXT--XTB---M?TM--o--||T-EM?-T--?-B|-|-Xo--M-----M--o|M-|-XXX-MBXB--M-E|-o-|T--E-T--TB-----|--?ME-T--EoX-EB-----o|-ET--X--|EXT-EBM-XoX
|----M?-o-|oE-B-?-----T--??-o-T--?E--|-----?-T-?o|T--EEB?|--?--oo|--?B----X---?-----o-TMX---E-BB--oo--|M|--T----B--XE--X?-X-B---BB----?-------M---E-B---B?B------MEB|---B--X--E--|B-X--oX---MX-B-T?oM-?B
mE-T--o--BM--T-T-----?----X---BT----|?-----------X?-oM-oX---B|?-XX---?o--M?--?B--MT-T-M-------E?----Bo-B?-B--XB----|BMo-B|-XB--M||B|XB|X|M--B?-?XM-EBo--------TTM----o-o-T|X---------o-M------??E-----B|
XXXXXXXXXXXXXXXXXXXXXXXXXXXXXXXXXXXXXXXXXXXXXXXXXXXXXXXXXXXXXXXXXXXXXXXXXXXXXXXXXXXXXXXXXEXXXXXXXXXXXXXXXXXXXXXXXXXXXXXXXXXXXXXXXXXXXXXXXXXXXXXXXXXXXXXXXXXXXXXXXXXXXXXXXXXXXXXXXXXXXXXXXXXMXXXXXXXXXXXX
