----------------------------------------------------------------------------------------------XXXXXXX-----------------------------o--------------------------------------------------------o------------
------------------------------------------------------------------------------------------------o-----M-------------------------------------------------------------------o-----------------------------
--------------------------------------------------------------------------------------------------------------------------------------------------------------------------------------------------------
-------------------------------------------------------------------------------------------------------------------------------BBBBBBB------------------------X-----------------------------------------
-------------------------------------------------------------------------------------------------------------------------------------------XXXXXXXX-----------------------------------------------------
---------------------------------------------------------------------------------------------------------------------------------------------------------o-----------------T----------------------------
--------------------?????--------------------------------XXXXX-----------------------------B-------------------------------------------------------------------------------|---M------------------------
---------------------------------X----------------X------------------------------------------------------------------------------------------------------------------------|-M-------------------------v
--------------------------------XX-----------------------X-----------------------------------------------o-----------------B--------------------------X-------------X------|---------------------------f
-------------------------------XXX---------------------------------------------------------B---------------------B-----------------------------------XX-----B------------XX|---------------------------f
-BTBBBBBB----------------T----XXXX--------X---------------------------------------------------------------------------------------------------------XXX--------------------|-------------?-------BBBBBBf
--|----------------------|---XXXXX?--------X-------------------------------------------------------------------------------------?-----------------TXXX-------X------------|---------------------------f
--|-----------------T----|--XXXXXX---------XX---------------------X----------T--------------------------------------------------------------------X|XXX-------------X------|---------------------------f
--|-----------------|----|-XXXXXXX---------XXX-------------------XX----------|------------X------------------------------------------------------XX|XXX--------------------|---------------------------f
m-|-----------------|----|XXXXXXXX---------XXXX-----------------XXX----------|-----oE----XX-----------E----------------E-----------E--------E---XXX|XXX--------o----------B|?---E-------E----------M---X
XX|XXXXXXXXXXXXXXXXX|XXXX|XXXXXXXXXXXXXXXXXXXXXXXXXXXXXXXXXXX--XXXX?-XXXXXXXX|XXXX------XXXXXXXXXXXXXXXXXXXXXXXXXXXXXXXXMXXXXXXXXXXXX--XXXXXXXXXXXX|XXXXXX-XXXXXXXXXXXXXXXX|----XXXXXXX--------XXXXXXXXX
