-o-o----?E--|------------|----?EB--E--E----M----T-M----?o-B--------o--B-??B--E---E-X--|-------T--E?-X----?To--E---B---T-----o------------X||-X-X-------o-|---E------?--T-EB-E----MTTo?oTT---ME---X-X-T--
-XE------M-o---E--M------M?------oE-|--E---|-T---------M------X---?-B?---MTX-----X-----E--T-E-o-----|TX-----T---M---ME------T----------o---BBo------B-------B--?----TX--oM-----E---T----?--T---o--?M----
-X--o-?----E----E---------T|-B--M-X------X-?------X--?---------X----B---E--BT--oT--E|B-E-X--|--X-M-----?----M-X---E?-B--M---T---EB---------|-XE-----X----o------E-------|B----T-B--o-X|----ET----|---o--
--MB-?-------------Mo-||----B---------XoM--oE----B-T-----TE---------E-?-o--o---M--B-------------------------EE|EB-|------E-o--T----|----?oMM-?--------|----T-----T----M----o-TT------M-X---oT----B-|?-E-
-------B-o----X----|T--B-M--ME---------T-EM--|X--------E--------B------T--X-----E--E-------B----E-X---E|-o----EX--?---o--B-E------|o--BBB--X-----M-oX----B--M--M----X-?XT--?|---?TBo----------M-----|---
-X----B-?-----------E----------M--M--|-----T---------?-------------BMM-----||----X-o--------o--X-|-?B-?-----M-TM----X-M--?-?--X?-o|-?--E-------BX-o-----X------E---X--------o-------BE-o-?--?--|--------
---X-o-------E-o-o---o----|---BTE----|E---X--|----T-------M-T--?--T--M-----------EM?-T---M--|---B-T-|?--------BB--------B-----|----oM-B-|-----T-------T----M----o--B--?--?--------------M-T----T-|-?E---
---M-T--M----E-------M-------?-T--?o-?----o---------T-B-------|-E--E---T-X---E----E-TB-o|-M------E---E-o-B----o|---|-E-----oX--T----B---?--B--X|o---------M-----|?-B------B|----T|--?M-|---------------v
-X------------E--M---T--M--M-|TETT--T---o--|------XT------X--------o-------M--|X---B-B---o------------X-E---?M----------?--X-?-|-------oX-E-B---------M---------o-------B-|B-|-?---BT----T---M-------B-f
-o----M----T--X?-M----o---M-----------E-?-E--B---ET--E-----Mo-------XM---BX-T-E---T---XM-----XE------X-T-----?oET----------M----------EoB----?--|----M-BET-o-X-oE---EEM----B-------o-E----------|------f
---ME--B---|-B---M----M-------?---M------X--o-----?o----o----M-----o--------E--XE?-M|B-M----?--?--?-|----B--E--|-----------B--o-M--------o---T-?-----M---o-o-ME---|B--------B---T--X-------|--X--------f
--T--B------?E---o------?|-M--?-o?----------E----?---ME-?-----?-------T-M--E-?--?--M--------o-------oT----T----------TM----?---B----X-----E-TE--||--o---------E----T----?--T--TM-M?--M--T---|-B---o-|o-f
--------M---T----------E--B----E-||--EB--------?----B-----B----o-?o|----------Xo---EE-XT-E---?----T----|--B-----o--B-X--E----E---X---M----T?---B----oB-B|----o----B-|B---oE--XE|?EMo-------?---M-------f
-----|-?--E---E-----E----M-E-oB---E-|X-|o--M-?-?-E------T----T--|-M?-----o------o----BM----X--E-----?B-XM--|--MM--X-X--BEM------?----|------------|----M-BT----M-----E-X---B--M--B-------E----M---?-?-Mf
mB-oX-------X--BETB--------------MTM----M-B-B---?|------T--o---o---B----||--X-------M--BT?-B--------M-o----MT-E-----------TB?-B-----------?-o--------B-B-----B|--E----??-----M---M-------E--o-B----o--BX
XXXXXXXXXXXXXXXXXXXXXXXXXXXXXXXXXXXXXXXXXXXXXXXXXXXXXXXXX?XXEXXXXXXXXXXXXXXXXXXXXXX|XXXXXXXXXXXXXXoXXXXXXXXXXXXXXXXXXXXXXXXXXX?XXXXXXXXXXXXoXXXXXXXXXXXXXXXXXXXXXXXXXXXXXXXXXXXXXXXXXXXXXXXXXXXXXXXXXXXX
