-------------------?---------------T------------------------------------------|----------------------------M-----------------------------------------------B--------o------E----------------------------
----------------------------------------?------------------------------o--------------------------------------o-----------------------------------------------------------------------------------------
---------------------------------------------------------------------------------------------------------------------------------------------M----------------------------------------------B-----------
--------------------------------------------------B------o-----------------------------------------------------------------------------------------------------------------------------------o----------
--------------------------------------------------------------------o---------------------|---------------------------------------------------------X-------------------------------o-------------------
---------------------------------------------------------?------------------------T------------------?-------X--------------------?---------------------------------------------------------------------
--T----------T------------X-----o-------------------------------------------------------------------------------------------------------------------B---------------------------------------------------
----------X-------------------------------B--------------------------------------B-----------------------?--------------------------------------------------------------------B--------------|-----|---v
------------------------------M--------------------B-------------------------------------------------------------------------------------------|------------------------------?------------------------f
---------------------------------X-------------------------------------------------------------------|---------------------------?---B-----------------------T-----------------------------------------f
--------------------------------o-----------T-----------------------X-------------------------?--------------------------------------------------------------------------------------------------------f
----------------------------------X--------------------B--------------------|--------------|-------------?-|------------------------------T?---------------?-------------------------------------------f
-------------------------------------------------X---------------------M------------------------------------------------------------------------------------------M------------------------------------f
-------------------------------E----------------------------------------------------------------------B------------------------------------------------------------------------------------------B-----f
m-----------------------------------------------------XX------------------------------E---X------------------------------------------------------------------------X-----------------------------------X
XXXXXXXXXXXXXXXXXXXXXXXXXXXXXXXXXXXXXXXXXXXXXXXXXXXXXXXXXXXXXXXXXXXXXXXXXXXX-XXXXXXXXXXXXXXXXXXXXXXXXXXXXXXXXXXXXXXXXXXXXXXXXXXXoXXXXXXXXXXXXXXXXXXEXXXXXXXXXXXXXXXXXXXX|XXXXXXXXXXXXXXXXXXXXXXXXX?XXXXX
