-oT---|--E---------M------M------B----ET----------M---B?-------------XB-??-B---|-E-B--|-T--------E-----o-?-----?MT----------o-----?----X-X|--X-----BB-ooo--o-EE-----?------------M--o?o-|---M--|-X-?----
----M|----|o-------------M?-T---X--------o-|-------XB-----B---X---?--?--------------|------ME--------oX---T|------E-ME-T-M-------------o---B-o---o-----?---------------Bo----BM---|---X--E--T---E--ME---
--------M------?E------------B----XM-----X----X---M-T---T-----|X----B---EB----B--?-----E-X--|-----||T-B--|-----------B-----?TE--------X------X--------?MBoE--B---------------oT----oBX|--EoET---E|--E?--
--MB-?----------M---o--|T|--BB-MT------------|T-------T-------o-----E---oE---------X---M---------M---T--B--XEE-E---T-------B--X-o--|----?oM-----M----E---?-----M---------Xo-T--X-----M------T-----T-?T--
----?T-B?oM--------|---B-M-?-----B---o|--E---|-----|------E-----B----E-T--------E-------------M-Eo--o----oX----X-----E-E--M-------|o-------------M-----E---T-------T--T|TTE?-----TM----------E-------ME-
-X----B----oX-T-------M------------|-|-EB?M----------?-o---E-BT-----M----X?|B----X-o------------X--?-E?-------TM------MM-------?--|-?---o----B-BX-o---E----T---E-------------|------B----?---o-----|--T-
------T---E-E--o------------B|B--M--------X--|----ToT-----M----?T---T-BX----?EB-?E---T?--M---X-?-----------E------------------|X---o-----------T--BE------------oX-------?---X-------B------------------
-o----|EM-B--E-------------------E?----|--oT--B|--X---------------------------------TB-oT-MEX------------B--?X---X---E--------TT-----T--?-BB--X-o---E-----M-|o---------X|X-|-----|E----|----X---X------v
-X-|--?-X-B---E------T---X-E---E-T--------oX--------X-----X-TEo----------E-----X-?---B------M-----M---XX-------------------X--T|-B----T-----BX---------------Xo-o---|X------?|----E-|--o--X------------f
------M--------?-MX--o--------|--|-M--E--TE-E----E-E-------------T--------XE----M-----X----X-XE-|-T----T------------X--------M-----E--E----T----|o---MM------X-oE----------B-o--M--o-E?--------M------of
---M-------|--B--M---------------------E----o-----?---T------M-E-E-o-?-----ME--T-?-M-------X------------------X-M-T-------M-------T-T-E-----------------?o-o-ME---|-------X---------X----?-|--X-----o--f
----|------E----B---ToB--|--X----X-------------------MB-?---------------M----------M----E---o--------T--------TX--o?-TM-----|--B----X-----E?-E--|----------?---o---T--X-??-T-?-----------?--|?B--?o--o-f
--------M--------------E-----T---||---B---M-B--?-----------T---o--E------|-o-X-o------XTBEo------T---B-|--B---?T-----X---M--?E---X---M---TT---------o---------------|--?---------EM----X--B----M--T|---f
-E--?--?---|-----------------oB---E-MX-------?-?--M------?-o-------?-------|-B----T-oB-----XE-----T--o----|-----T-X-X----------B?--B--oME-B------------MBB-----M--?----X-ETB----X------T-----BM-------of
m-T----o---------TB--------------MTM------B-B-----EE--?-X-------E--B----||----|-T-----M--?-----|---------M-MT-E-|---------TB-XB-------|--o-?o------------X|o-B|--?------E--|M----M--B-------------X--oBX
XXXXXXXXXXXXXXXXXXXXXXXXXXXXXXXXXXXXXXXXXXXXXXXXXXX|XXXXXXXXXXXXXXXXXXXXXXXXXXXXXXXXXXXXXXXXXXXXXXXXXXXXXXXXXXXXXXXXXXXXXXXXXXXXXXXXXXXXXXXXXXXXXXXXXXXXXXXXXXXXXXXXXXXX?XXXXXXXXXXXXXXXXXXXXXXXXXXXXXXX
