------------------------------------------------------M--------------------------------------------------------------------------------------------------------?------------------|---------------------
-?------------------X--------------------------------M-----------------------T---------------------------T-----------------------------------------------------T-o--------------------------------------
------------------o----------------------o-------------------------------------------------------------------------------B--------------------------------------X---------------------------------------
------------------------------------------------------------------------------------------------------------------------------M-------------------------------------------------------------------------
---------------------T------------------------------------------------------------|---------------------------------------------------------------------------------------------------------------------
------T----------------------------------------------------------------T------------------------------------------------------------------T--------------------------------|----------------------------
----------------------M-----------?-------------B--------------------------------------------------------------------X---------------------------------------------|-----------M------------------------
--------------------------------------------------------------------------------------------------------------------------------------------------------B--B-------------------------------------------v
-------------------------------------------------------X-----------------B---------------------B--------------E------M-------------------------B-M-----------------------------------------------------f
-------------------------M-----------?-?----------|---------------------------------T------------------------------------------------------------------------------------------------------------------f
-----T--------------------|-------------------------------------------------------------------------------BT---------X--------------------------------------------------------------------------------Tf
------------------|-------|--------|----------------------T--------------o-B----------------X-----------------------------------------------------T-------B----------------E-----o---------------------f
-------------------------------------------------------------------------------------M--B--------|--------------------------------------?-------------|------------------------------?-----------------f
----------------------------------------------------------------------------------?------------------------?----------|--------------------------------------------------------------------------------f
m------------------E---------------------------------------------------------------------------------------------------------------------------------------------------------E-------------------------X
XXXXXXXXXXXXXXXXXXXXXXXXXXXXXXXXXXXXXXXXoXXXXXXXX-XXXXXXXXXXXXXXXXXXXXXXXX|XXXX-XXXXXXXXXXXXXXXXXXXXXXXXXXXXXXXXXXXXXXXXXXXXXXX-XXXXXXXXXXXXXXXXXXXXX|XXXXXXXXXXXXXXXXXXXXXXXXXXXXXXXXXX|XXXXXXXXXXXXXXX
