----------------------------------------------------------------------------------------------XXXXXXX-----------------------------o---------------------------------------------------------------------
------------------------------------------------------------------------------------------------------M-------------------------------------------------------------------o---o-------------------------
---------------------------------------------------------------------------------------------------------------------------------------------------------X----------------------------------------------
-------------------------------------------------------------------------------------------------------------------------------BBBBBBB------------------------------------------------------------------
-------------------------------------------------------------------------------------------------------------------------------------------XXXXXXXX-----------------------------------------------------
--------------------------------------------------------------------------------------------------------------------------------------------------------------------------------------------------------
--------------------?????--------------------------------XXXXX-----------------------------B----------------------------------------------------------------------------------T-------------------T-----
---------------------------------X----------------X-----------------------------------------------------------------------------------------------------------X--------------M|-------------------|----v
--------------------------------XX-----------------------X-----------------------------------------------o-----------------B----------------------------------------X---------|-------------------|----f
-------------------------------XXX---------------------------------------------------------B---------------------B-------------------------------------------------------XXX--|-------------------|----f
-BTBBBBBB----------------T----XXXX--------X-----------------------------------------------------------------------------------------------------------------------------------|----------?-------B|BBBBf
--|----------------------|---XXXXX?--------X-------------------------------------------------------------------------------------?-----------------T--------------------------|-------XX----------|----f
--|-----------------T----|--XXXXXX---------XX---------------------X----------T---------------------------------------------------------------------|----------------X---------|-------------------|----f
--|-----------------|----|-XXXXXXX---------XXX-------------------XX----------|------------X--------------------------------------------------------|--------------------------|-------------------|----f
m-|-----------------|----|XXXXXXXX---------XXXX-----------------XXX----------|-----oE----XX----------------------------E-----------E--------E------|----------------------???-|----------------E--|M---X
XX|XXXXXXXXXXXXXXXXX|XXXX|XXXXXXXXXXXXXXXXXXXXXXXXXXXXXXXXXXX--XXXX?-XXXXXXXX|XXXX------XXXXXXXXXXXXXXXXXXXXXXXXXXXXXXXXMXXXXXXXXXXXXXXXXXXXXXXXXXX|XXXXXX-XXXXXXXXXXXXXXXXXXX|XXXXXXXX--------XXX|XXXXX
