-B------o?B-MB---------------BE--------T--o-|----|-------B--X---o-X----M--TE--------o---M-?Bo---TB-----------|----E--------------------X------M-----XE-E-----?-B-----X--o-|-E-----------------------E-B-
----------E--X---EB----o--o------------T--?-ToB-B--XBE--E-----X---oEE---E---------------?--E--B-B--?o-----?------------XT------XE---E--B---?--B------E---M-o--o---------?-----M-M---|----------?-oM-----
---E-Bo-----B----M---o--ET-------|------------T-------T--XE--------E----B---------M-M-----------E----|----X?--|---M-o---M--?--?---o|--T------------X----E--M?-M----------------------X---------o---B----
------|B------|--oX----------|-?---?---?-|----T-T-E----EEX-------X---o|E------------------o--M-B--?o-----M-----E|--T-T-M--|B-T--T-X--MT-ooXX-oXM-------------T---------|------B--BX-|-B---|-----|o------
--B-------TE-EX-T-|--------?-------o-----------M------EMT---?-B--------------o--BE------------------B--EBo-------X--|----|----------o-T--XMT----E----M---|---|-----T----o-M----------M--BM---M-----?----
-E------------M--|o---?-M-T------------o--|?----E-|------B--X-X-------E-----MT---X---EM---B------E----M--E-|---X---E-|BE-----|--B-|--Xo-E----M-E-X--o--E|-|-----o--|TE--|---E--B-------?-M-X----E--B----
--?-?--X-------|---------T---Bo--|M--M------------|-oB--X----?-B-----|E---M---------?---BB|------------?--|------------T-----------TE---X-----M---|-X------X-?-----o-------o----B--|-----B-E---?-|------
--------?-EE--o----E-M-----o------------B------oX----XTB------X----E-----?------o--X----B----o------T-B--------o----oX--------oM-T----o----M---oTT--E----B---|----X-M---E--E--|-B---E--------|--B------v
---ET-??-|--??----o-M--XBX-------|----E---------M--TB--oM-B---T--o----X--E--T-----------T--E--E?|---X-T--|-----T|-----X?---?--E----E|E|------o--------------o---X-M-T---B--o---E|--M?------o-o------T--f
--|----MB-----?M----|M----E----E--|------------M--B---B---|Xo---XB---?----------To-----?----------?-?------o-M----------X-----?-Mo-----B-B--------?--------B--oM---------B---X-BE-----------M---E--T---f
---E---E?---XTB|X--?-T--XX-?Eo----T--|--------M--B----|---?-M--X----E-XBM--T--|T-|--T|-X----|TX-B--------?B-X--------?-BX------------------B--?----------o-------B----------M--E-M|E|-|T----X----M-B-oTf
-?-|T-|--|---------------------T------B----?-------X?M---T|-B---o-------M----E-M-?----oX------?--E-----?-|-X--B--?-----?--------?-?oE-?--|--------EM--o-B---B-??-TT-M--B---?-----|E|--M----T------B--M?f
-----------------------M-----E-X-----B|----------?B---o-T----------X--|--M-------------------?-------TX--?--T-----o--E----B---Mo------B-------|-B-----T-?--X------o--T--------XE?-o-T---|--T---X----M-|f
----o-------|--|-------T-----EB--E-------To----EM?---M----X--T-|-------------o--------?---MXT-----EB----M?-M--B------M---|-BM-----|B-oM-|?-----M------|--EE--------------------X-B---------T-M?--?---?-f
m----?-|-------TT----|--?--------M------B-o-|-------X----------------------------X--B---?---X-----B----MT------o--T-o------X----??-----X-----Bo-oE?----E--?-o--?------M--B-------B-|-?----E---X--|-----X
XXXXXXXXXXXXXXXXMXXXXXXXXXXXXXXXXXXXXXXXXXXXXXXXXXXXXXXXXXXXXXXXXXXXXXXXoXXXoXXBXoXXXXXXXXX-XXXXXXXXXXXXXXXXXXXXXXXXXXXEXXXXXXXXXXXXXXXXTXXXXXXXXXXXXXXXXXXXXXXXXXXXXXXXXX|XXXXXXXXXXXXXXXXXXXXXXXXXXXXX
