---B---------------X--------o-------X--------E-------oo----------M-----E---??-------E----------------X--o-------------------E-----M-------X-------------X------------B----M-----E-----oX----------------
----------------------------?---E---M---------B-E----------T-----X------------------------------------XX----------?---E-o------------------------M-----X-M------------------X-----?-------M-----E-------
---T-----------------o---X----M---T---------?---B---o------M--?------E-M--B-------------M-E----------------T--E-?-----------X------------E-------------?-----------------------E-----T--------E-----M---
---X-------X--XM----E----T--------M--------M----------------M--X------M-?M-----------------------??--------M-M----------------X-----o--E--T-BXE--M-T-----------------B-B----?--------B--------?--E------
-------B-E-------------X-B-------------X---?------------??-------X---------E------------oX----o------E----?----------------B----------B---M----M---?--E-------------------------M------B-----------B----
-------EB-----------?-----B-------------?-----------X----B-X-----X---?--------B----oT----?T-----------T-----------XX-------?----o-----------?--------o------------------------B---------------B---------
----X--------------------------------o-----------o----------X---------X---E------M-?M--?--M-----------|---------?B-----o--------o---------------E-MX-?--------X---X--E-----------------T----------------
-----------------M-X--------------------o---------o---?--B---B-----B------------E-------E-------T----XX?-?-X-------M------X-----------E--------o-?----------T---------M--?-B-----TB----M??----B--------v
----M---------------------o-------M--?--BX---E---T-M---o------------oB---B-------------------M--B--------?-X--------------M---------------?---o--XMX--------X-?------M---M-M-----M-----B---------------f
------E----?X---------M-----------E--------?----o?-------M--------------?---------------------------o---------------T----E-?----To--------Eo-----o----XE---------Xo-o-----B-----X--o-E-B-M----BX----E--f
----------o---------E-----E------ME-B--B--------------MB---EX--X------E-------o-----X----------o-----?E----?o----??-X-M------BB-M---------------------X----------M------------E--E-M------------XX--E--f
------------?-----?-X?-----------------o-------B--o----------------X--o-------B-X-------------?E--------M?-------------o-------M------X--E---o----------T---------B----------X-----------X-------------f
------------------------------------M----------X-------------------------E-----------------------------------B---------?------------------------------B-|--T?-T--X---------------------------X---T-----f
------E---o----?--ME-M-------B--o-------------------B--------------T-------------------o------B------------B-----o-----?---X------B------?B-X-----------X--X--M----B---------o----?----T--o------X-----f
m----------------------T---T--B---?-E------E--------------M--------?------------T--------o-----M------------B------------E------?----------o------------------------E--------------T---|---------TM----X
XXXXXXXXXXXXXXXXXXXXXXXXXXXXXXXXXXXXXXXXXXXXXXXXXXXXXXXXXXXXXXXXXXXXXXXXXXXXXXXXXXXXXXXXXXXXXXXXXXXXXXXXXXXXXXXXXXXXXXXXXXX-XXXXXXXXXXXXXXXXXXXXXXXXXXXXXXX-XXXXXXXXXXXXXXXXXXXXXXXXXXXXXXXXXXXXXXXXXXXX
