-------------------------------E--------------------------------------------------------------------------------------------------------------------------------------------------------------?---------
-----------------------------------------M------------------------|---------------------------------------------------------|-----T------------------------------------------B--------------------------
--------------------------------------------------------------------------------------X--------------------------------------------------?--------------M-----------------------------------------------
-----------------------------------------------------M--------------------------------------------------------------------------------------------------------------------------------------------------
---------------------------------|-----------------------------|---------------------------------------------------------?------------------------------------------------------------------------------
------------T------------?-----------------------------------------------?-------------------------------------------------------------------------?--------------------------?T------------------------
--------------------------------------------------------------------------------------------------------------------------------------------------------------------------------------------------------
-----------------------M--------|---------B----T----------B---------------|------B-------------------------------o---------------------------------------------?--------------B------------------------v
----------------------------X----------------------B------T------------?-----------------------------------------------------------------------X-------------------------------------------------------f
-------------|---------------------------------------------------------------------------------------------------------------------------B------------------------------------------o----------o-------f
----------------------------o------------------------------M------------------------T-------------------------------------------------------?----o-----------------------------------------------------f
--------?-------------X--------------------------------B------------------------------------|--------------|---------------T---------------------------------------------------------------------------f
------------------------------------------------------------X------------------------------------------------------------|-------------------X----------------T---o------------------------------------f
-----------------------o----------X----------------------------------M-----B-----------X-----------------------X--------------------------T---------------------T----M---------------------------B-----f
m---------------------------------o-------------------E----------------------?------------X------------------------------------------------------------------------------------------------------------X
XXXXXXXXXXXXX|XXXXXXXXXXXXXXXXXXXXX?XXXXXXXXXXXXXXXXXXXXXXXXXXXXXXXXXXXXXBXXXXXXXXXXXXXXXXXXXXXXXXXXXXXXXXXXXXXXXXXXXXXXTXXXXXXXXXXXXXXXXXXXXXXXXXXXXXXXXXXXXXXXXXXXXXXX|XXXXXXXXXXXXXXXXXXXXXXXXXXXXXXX
