--TB--X--o-EBEB---|E-X--B--------E---oT|--?T-TB-MMo|-M-?-M-?--?XX-BB---??-T-X--T---?---B?-o----BE-M-o-X--M-E?-XB-B-TM-X-XB|-----X--T-E-XB|-B|-X-------E-M|---TB-|-o--E---?XM--E?-T----X--B-EXM--T-B--M--
-T--|--?-M-M|-T-E-----T?BX--|-----BE------?B---M----?-T----B-|--E--E-?---|--ET-----|-E---o-o----------T-------|EBX-?T-XE-Xoo--B---o-X-E--M---o--M--B-TBM----M---o-EM|--T---?--B---|MB---BBE-oo-E-?---T--
----X---------T-|-o----?-|--T|TET|--XE-o--E-TBo--o-|-----E-----?-X-|--B?o--?oT------M-?o-BBM--B?T-E---?-?------X-TX?--o|-|B---|-X-------BB-T-------?T?BE--BB-BB|?E----?X----EX-T--o?--B--E-o-?---T----|-
-T-EBT|X-M-?-M|--?X|--oB|---?-B--X|-----?X-o---M-T|X|B-E-o-MM----E|---?-|MEXX-?X--o-E-T--TX----|B---E-M?--T-?---Xo-B-o-?-B-?|BT-------|?---E-------o-E-X--|T|----T--TX-M?|--M--?|B---X---EB|--|--X|TE?--
-|-T-MX--B?M--o----?-o----M--|-E-B-X-?-o-XMX---?-X--X-o-BE-X-oB?-|XEBE-M--E----?---?B--------MM--oo-o-X-B-?-E-o|----?X--TE---oB--|?---|E?M-?-?-X-XB--?MBT-M---B----|-o------ME-----X|-M----Bo-oBM-BB-o--
-B-----B-----Eo--X------?M-ME-o-o|T--o--?--oB-E-T--M----BB-?|-----o-----B-EB--X-|TB--X-T-|-T-M?-----|M---??----oo--X-?ooM-M--BTX--MB-|E----E--MX---X-EEBE----|-----Bo--EX?-|-------M-Too?X|X-E-M---X----
-o--|-?-----T--B--oB---E---o-XBX--o?T|------o-TM----------E-EEXT---BMB-X--?o-------|-MXB---o--TXXME-----X-M-BB--|?M------?-M-oB?--?TT-E--?-B------E----B---EX--XXE--EToM-o??B---o-X----TE-|?------------
--|--|---|-MT----B--T--M-M--X--|-o-E-XM---T-|?o-X-------X|o---|Mo--oM-M-T-----oB-E---X-E--TE---|o-Xo-TM|--?--Bo-|----E--MTM----o-?---|--MM--TXTM-E---X-o-E--X|----T-T?E---TBXEM-|X--TBE----oo|----?----v
--B--o--------B--X--M-T-E-T-MoT--E-|--E-?-o------o-Xo|XE--BT--XX---|--X-TX-X--EB?--E|X?MT-E-M-ETXE---E--|---ME-------EM--MT-|?XB|----B-BB-B--TBM|--To-|MTT---MXX------?-X------|?--MMB-|T--------M---B-f
--BE--XoM---?MBM-?EB---TBEB--?-MBo-|-?ETM--M---X-----E-o-ooX--M----E---MT--BBTB-E?-|-o-B-T?----BME|E-B-B-ET-E-X-B-oMT----X-oE--oE-|---EE-E------Eo---M-?-E---?T-?-|oB------T---||oET----------B-?-X|?-Ef
--------oEo-?-o--X-X---o--B---E---B-----?-?-Xo-----|---TXB----E?T----XT-----------|---M---TT|B|-M-o-T--M-BTo--TX-X-----M---B-E--o|--o|-T-----|B------|-Mo-M----|-----T?---|o---o---T-----T-X---XB-MoMB-f
-?--B--T-ET-BM--BT-oME--MX?-XT?--X----?--o|-----T------o-TBT|-----EMX----T--T-----XM----?XMEE-EB-----o---E--o-E---EXTTEMX----o-ETE-|B-----B--T--BT-M|-E----|E--T-M---|-------Xo-EE-||-----T---E-|M-EBE-f
-----oXX|-----|E---B--|MX-XX--o?oBET--BBX|MX--|X|E--|--EM-|--||T--EX------EX-TE-TME-----o-X-----|E------X?o--?--E-X--M--o-M-M-TX----oX--E-BXXT-XE--BB-?XT|T--T-T--ME-X-oMEo-BBoE---M----|-BB---XoBXE-T-f
-----E-------X---??|T--o||-BTME------BT-E?BT-T-E----M---?-X-oE?E-EB-------B-X-EE|--?T--T?-B-EM---o--X----X--|XX--M--|---------X?-MBoT----M--------E--o-o-EoM----MB--T-?|o--o-B?B--TM--?---EB-M-MoooTo--f
mBB-|-?--T-MoX---X-Mo-BoM----TE-------B-MX-B-oM--B-TM-?--TB---------M---X--M|-M?-----o--TT-B-X---E|MX|---M-ET--MM---o-E---B-Mo--TT--|----|-oME-BE-MT---E--M--|--M----?---E-?-Mo-T-E--|-XB-|E-M|oo|-oB-|X
XXXXXXXXXXXXXXXXXXXXXXXXXXXXXXXXXXXXXXXXXXXXXXXXXXXXXXXXXXXXXXXXXXXXXXXXXXXXXXXXXXXXXXXXXXXXXXXXXXXXXXXXXXXXXXXXXXXXXXXXXXXXXXXXXXXXXXXXXXXXXXXXXXXXXXXXXXXXXXXXXXXXXXXXXXXXXXXXXXXXXXXXXXXXXXXXXXXXX-XX
