---ME---X-----B-o|---oEoM?BE-ET-M|X-E-----------M----T?-?-?-|---E--|-B?---B----M-o-E?---MM---M--B-MB?--X-X-B--?oMo-?B-X-BM-?--|BE-o--B??T-BT---X--E----?-E|-----E-B-oo--T-E-BTE-?--o?--E-T?XE---|BB--|o-
-To-?-B?-E-o-|---T|------T-||oBE--o--XX--o-|o|-o------M-o?---MT-E----E--o?--M-oET-B------TX-M-?-o-B-----M---o------|o----?To-----EX-----E--B---?-T-?-E---M?--oE---Eo----MEMo?--T-|-o-ET-----?-|E----?---
-M-----X---o--T-B--X--B----o-|T|M-o----TTo-BE--|-?--o|---T-?--|-----T--M--|o-MXEo-B-T---|----B-|To-|---|--M-E|-----|-B--||---MTE--|TMBBE?|---M------|-MM--XE-BE--M--X-TE|-T|X--?MoT-X------|M-M-Xo---oB-
--oEo----B---BBB-o-M?----E---EMo?oX|?B--?-E-----o-o--oM-?---E-------oMMTE--B-X---X?-oooo?-|ET-----EoMM---T--E-EX------o---?B--|oT-EE-|?-EB-----X-X----o-M-T-Xo----X-X-T--------|--T---B-M-o?--ET-|-T--X-
--o-E?M-BT--X?---?--B----MTE-T-EX--T-oT-o-E-B-?XT---MM---??|o--TXo-M--E-BX--MB-?B--|-----|EB--M|XB|--X|?-M-|?T---X----BT----Eo-----X--|---??-o-o-T?---MMX----B-o-T?-MM-M---B----B-TX-BoX|E-----X-o-M----
----?-MBE-o-|--M|Boo--|Eo-?-?oT-E--?-?X-?T---|-T------M-TT|X--E-M--Xo-M|E||?----M--|-|MBX|oT--B-|---TBE---XX-TE-T-EM-?-oo-T--TB?-B--E-BMT-B|---B?oEBX---T---B?---o-|-TE---X---E---T--T---B-EEo--o-|--o--
--ooM--M-XBE|?-?-oM-MB-----E---To-T----|X-B-B?--|oB-E--oE--TT||B-----X-ToX-?X-?XB-BB-E----?T-E-o-|-X--B---B--?---M--X--o---TX-o--E-Mo-----o--T-E-|X----|?MM---B-?T-o?M---B--|-X------EB-|--?o-oT-?--o|E-
---?B-EEo---M-----T-X-----T-E?o--?-EE|X--MM----|M--B-----E----X-X---M-|-|o-T|o--|---B----M-M-o-M-X--?-T|BX---o--T|M--MB|-|-M------M--B-M-M?---BX---o----TX-T?E??---X-|B-B-X-o--B-XB---E----T-T-o---?-M|v
---MX---B-o--E-M-??--T--?------oM-TMB--TE-X-----o---T-?X---?-o--M--M?--T-M|--o--o-TT---?B----T-MT-oo-o-XBE-M-M---M-?-|----B---M-E-oT-|--o--E-?--oTB-?-|-|E--o----M-M-E--E-X-?-?o--E---?-|EMToMB-M|XXX-Tf
-B---X|E|TE---|----MoXM?---To-----M---X--MEET---?---T?--M---M?MT---oET?--T-oo-X----------oE|-XB?-EB-|---?-?-M-EB||X--|---Xo---T-EME--M--B--EMo-MB------M-----------oE|M-|--|-----|XBB---T-?-M---oM---B-f
----B--BoB-EB---Xo-X--??MT--??E---X-?--------B-|--X-TT---X??------M--oXM--o---TE-EoX---|--M-o-B-E-----X?-??--?MX---oM?---BEM------XET-XX?-MB--oM-o--XX?T--EE|-|-Mo-E----MBX-----oM---T--E----B-TXB---EXf
--TT-------B-B-----MEBo-TE--o---B--X---E?---------B-|B|T-?Eo-o-?B|-o-XE-T-B-MM?-o--?XBEoT-X--TETX----MM--B-MT--EMXX--o||----o|B------------BM--|EM-?--|---?E-B-?XX--X---TTE-o-M--X---EE--XT-----TTE-X--f
--T---??B---o--X-TM---|-|-B--M--?-M|-XX-T-|---E-MX--|----E----B-?T--EB---E|-|---BM--TXT--------X-----|--o?-TB-----X--BX?---EME-?---M-EB-?--X-----?-M---E---E-------?-TB-|----TBM-X-T--XM-X?----?-Xooo-Bf
-o----T---M--EEE--TEoTXEM|T-B---M-------?X-?To-??---EX---E-EEE---M-o-M-M---oM-||-?M|-?B-ooTTE-?M---E?BBTBE-|------|--oB-----?B--o-BE-------B-T-----XB--|-|---?-X---BE?-Mo-M--M-M---|-BTE-E-?-X-Mo------f
mBTE--------|-?--o-?-----|EM---Xoo---X--XTBo-o-MEM-|M-o--|-BX---TTT---M--XTE?-TX-----oE---T-B--XM-MBMT--B?B-?Mo--|X-E--E----M-M---E----E--??B----oTE-M---|--XE---Xoo?|M-?E-|-??--XX?BX-o-BE-|BX-o---X--X
XXXXXXXXXXXXXXXXXXXTXXXXXXXXXXXXXXXXXXXXXXXXXXXXXXXXXXXXXXXXXXXXXXXXXXXXXXXXXXXXXXXXXXXXXXXXXXXXXXXXXXXXXXXXXXXXXXXXXXXXXXXXXXXXXXXXEXXXXXXXXXXXXXXXXXXXXXXXXXXXXXXXXXXXXXXXXXXXXXXXXXXXXXXXXXXXXXXXXXXX
