---E------MTBBT-----B----E?M--?X--------E---o?-E--oT-X-?-EX-X--?------?---?-MB------MB--------B---oX---o---------M--BB------BX----E--E-XM-o-E-----o------M--o-T------B|---M-|-M--EBB-M-------?--o---?MX-
--M-oM-|---o-?---o-B-B----X-M-o-------|----|B-M----?-?E-------M-X---X--|E--X----EM-BM-E--B??------EM-|X----X-E--EBEXT-------|-T|--ET-E--E-T----B---|E---------|--M-T?-T-M-------E--?---X----E?-B?-|T-|--
-E-?X-?----|B--T-B-----|-oM-oX----M----oBX---T--M--EB-?-B-ME----X--||---M--?XX--E-|----B------M--?----E-?-M----|-E----M----o-XM-X-|o--o--X-----|-T-----o----TB---T-E--X-------------E-----M--?-ME---B---
-METT----X------T?--EMoo-?M------B-?--E|----M------E--E-?-M-T-------------o-M----?---E----?E--E----E?---X----|-----X------o-----------E---TX---T---M-?-E-|--B--X---o--?----T---B|-X-?-X--X-XT-?---X--E--
-Bo---X-M--oX-----Mo--T------X-T------M-EX-------------B---X-|-TT----X---X--M----------o---X--oTM----E-----MT-B|------E|-----------XMT--T-B--------o-|---T---E?E-?---T-B------X--E-XT-------M-------|---
---B-B-T----E-E---o---B-----Mo-----T-|--TXo------MBo--TB-----T------EX-B---?-MMX-|---X--------B--M--MT-----T--XXo----M---EoT-----?--oE-MTX------MM|BX?-|-BX-|----?EXXBMTB---o?------B-E--|--E-B-------|-
-----o--BM-X?-|-T|T----||--oE?-----Xo-X-BM--E-----------T-----M--------o-------------E--MM---|-EE-B----o--o-?--?-B|---oo-o-|-BME-|-----------B--EB--o------|------T-B---X-M--o-------|XB--E---M-M?-BX---
---o-|-o-B-T--X-----|---M------X-B--|-M-----?---T-X-----M----M-?-T-MMM----?-T-----B------T-----X--B-------?TM----BT-o----M-----|------o----B-?E-M---M-o-o-EB-|BE-------?---?E----?--M|----?-M-|------Xov
---o-MoE-o-M---------X---o-----?-o-B-B-BX----|---o-T-?--?o----B-o--|-----E----TM--------------o--T------------?-B--X-?-------B-M---E?-M-|?-E-|?-M-------?--?-?-E--T--------B----T-|?|o------E|-----?---f
-MM--|-M---o------T?-o----|X------?M--X------M?|-E---o-E------oE|--M-X?---B-|o--TM--M-----?--E----?|-ET--B--T----B--|---E--?----M-M----E--Mo----E--X---o--T--MMEo--?--E-----?---B-?X------B----?oB---o-f
-----BB--E--------TB----BX-XX-XM?--EB----X------T------------B---E-?|M---------EE-M|--------MoMM----BB--X-------?-----T----T----|---?|M|----o--?---T-E--T-----oM---o--?-o-----o-E--BM---|---E---X-?|---f
-o--X----E-o--?-o----o---------o----BEB---B---------B---B-E----M--TT|T--?----------o----T-M-BE-?-o---o-B-oT-oB--o-----o--------?X--E-----o---o-M-Eo-?----BE-X----|--?----o-ooM-TMoT---XB-----Xo--M-|-|-f
---|---o---o-B-?|oM----|----X-E-TX--M--E--------T-------E--XoM-----?-B-E-T--o?M-o---BEB-------B-M--|--?-?----X--T--T-E?--BT----E----E--------EXE-------------B?-B-----T?----M|-----o--??----X-E-?T-EM?-f
--oB------B------X-----------X---B-M---X--X---?M----B--XE----E?----?-----M--------XT?T-|---|------?Bo----E--E?-B---XMM-E-----|--BT-----|X-E-BB|o------E?--M-E|-o--M---o-o-----B--T-X------T--XTM|---T--f
m------B-B------X-M-o-o-B--T---|-B-ETM-o-----------|----B--------?-B-E---o----X-------X--oM--E--?---X-|---XB-o-B|o-?--MTM--E----|-?--?-------E-ooB-----|-T-----oE-E-B-o---M----------o?--??M-X---X-T--TX
XXXXXXXXXXXXXXXXXXXXXXXXXXXXXXXXXBXXXXXXXXXXXXXXXXXXXXXXXXXXXXXXXXXXXXXXX?XXXXXXXXXXXXXXEX?XXXXXXXXXXXXXXXXXXXXXXXXXXXXXXXXXXXXXXXXXXXXXXXXXXXXXXXXXXXXXXXXXXXXXXXXXXXXXXXXXXXXXXX?XMXXXXXXXXXXXXXXXXX-X
