--------------------------------------------------------------------------------------------------------------------------------------------------------------------------------------------------------
--------------------------------------------------------------------------------------------------------------------------------------------------------------------------------------------------------
-----------B-------------------------------------------B----------------------------B-------------------------------------------------------------------------------------------------------------------
-----------------------------------------------------------------------------------------------------------------------------E-----------------------------------------------------------T--------------
-o--------------------------------------B-----------------------------------------------------------------------------------------------M---------------------------------------------------------------
----------------------B---------------------------------------|---------------------------------------------------o----?---------------B-----------------|----------------------------------------------
--------------------------------?---M-M-------------------------?------------------------o--------------------------------------------------------------------------------------------------------------
--------------------|--------------------------------------------------------------------------X---------------B---------------------------------------------------------------------------------------v
----------------------------------------------------------------E------o---------------B----------------------------------------------------------------------------------------------------------|----f
-------------------------------|--------------------------------?-----------------------------------------------------?---------------------------M-----------|----------------------------------------f
---------?---E-------------------?-------------------------------------------------------------------------------------------------------------------T-----------------------B-M-----------------------f
---------------------------------------------------T-----------------------------X-----------------------------------M-B---|--------B------------------------------------------------------------------f
----------------------|------E-----|-------------X-----------------------------------------------------------------------------------------------------------M------------------------E----------------f
------------------------------------------------------------T-------------------------------------------B-------B-----------------------------------------------|-------------------------o-|----------f
m------------------------------------------------o---------------------------------------------------M-------------------------------------------------------------------T-----------------------------X
XXX-XXXXXXXXXXXXXXXXXXXXXXXXXXXXXXXXXXXXXXXXXXXXXX|XXXXXXXXXXXXXXXXXXXXXXXXXXXXXXXXXXXXXXXXXXXXXXXXXXXXXXXXXXXXXXXXXXXXXXXXXXXXXoXXXXXXXXXXXXXXXXXXXXXXXXXXXXXXXXXXXXXXXXXXXXXXXXXXXXXXXXXXXXXXXXXXXXXXX
