--------------------------------------------------------------------------------------------------------------------------------------------------------------------------------------------------------
------------------------------------------------------------------------------------------------------------------------------------------------------------------------------------------------?-------
--------------------------------------------------------------------------------------------------------------------------------------------------------------------------------------------------------
-----------------------------------------------M--------------------------------------------------------------------------------------------------------------------------------------------------------
-X--------------------------------------------------X------X-----BBBB---T--------------------------o--------------------------------------M--X----------------------------------------------------------
-------B-------------------------------------------XX-------------------|-------------------------------------------------------------------XX----------------------------------------------------------
-----------------------------------------------T--XXX-------------------|------------------------------------------------------------------XXX----------??????------------------------------------------
-----------------------------------------------|-XXXX-------------------|-------------------------------------X----------X----------------XXXX---------------------------------------------------------v
-----------------------------------------------|XXXXX-------------------|------------------------------------XX---------XX---------------XXXXX---------------------------------------------------------f
-----------------------------------------------|XXXXX-------------------|-----------------------X-----------XXX--------XXX--------------XXXXXX---------------------------------------------------------f
----------------------------------------------X|XXXXX-------------------|----------------------------------XXXX-------XXXX-------------XXXXXXX---------------------------------------------------------f
------------------o--------------------------XX|XXXXX-------------------|-X--------T----------------------XXXXX------XXXXX------------XXXXXXXX---------------------------------X-----------------------f
------------------------------X-------------XXX|XXXXX-------------------|----------|---------------------XXXXXX-----XXXXXX-----------XXXXXXXXX---------------T-----------------T-----------------------f
------------------------------XX-----------XXXX|XXXXX-------------------|----------|-----o--------------XXXXXXX----XXXXXXX----------XXXXXXXXXX---------------|-----------------|-----------------------f
m-------E---------------------XXX---------XXXXX|XXXXX--E----------------|----------|---------------E---XXXXXXXX---XXXXXXXX-Eo------XXXXXXXXXXXE--------------|-----------------|-----------------------X
X---XXXX????XXXXXXXXXXXXXXXXXXXXXXXXXXXXXXXXXXX|XXXXX-XXXX-----XXXXXXXXX|XXXXXXXXXX|XXXXXXXXXXXXXXXXXXXXXXXXXXXXXXXXXXXXXXXXXXXXXXXXXXXXXXXXXXXXXXXXXXXXXXXXX|XXXXXXXXXXXXXXXXX|XXXXXXXXXXXXXXXXXXX----X
