-MXMo?-XB?oXooEEM-?BB?E|E?-?EMEMBXoX-MMT-?ToT|-XE|BTXoE-B-?|BTM-XM|XTE-M??|ooXXBTEET-oMBBEMXM-Mo|-E?-BXoEX|XBBo-M|M|?ToM-MT|-|XM-B|M-XoEoMXEoBE-o|??BMTooTTB?B-E?-EMB?EX?E-X?XMMT-X|-EMBXTX?|oB?-oB-ETEM
o-M?X|M?BM||E-|T-|BoM|T|||oM|M--EBE-?|||XT|o||T|?|||?X-||B||M|BE|o|B|?|||M|-||XE||-|-|B?MB-T||TE|X?X-|M?ME|-MoXo||o|-||B|E||-||BM-|MME|TTBoBB||-B||?Bo|oE||TXMT|-T-BM||E?B?|T||?||||ET?M||TE|||-T|XTB|TB
?E|??|M|-|||-M||X|T?||||||||||XM||EE||||M|||||||B||||B|||?||X|BB|o|||-|||||X||?||||||||||||||||-|E-|||||||||X?BB||M||||M|E|||||EEE||-X|||||B||||M||||X|-||||||||-|XB|||X|T||||||||||T|XX|||T|||-||B||||B
E||X||||||||B?||||||||||||||||M||||||||||||||||||||||?|||E|||||T|B|||||||||M||T||||||||||||||||-||||||||||||-?||||X||||||||||||BE||||T|||||-||||M||||T||||||||||o|XE|||||||||||||||||||o|||||||E|||||||?
X|||||||||||M|||||||||||||||||E||||||||||||||||||||||||||||||||||?|||||||||||||||||||||||||||||||||||||||||||?|||||||||||||||||o|||||||||||T||||||||||||||||||||?||X|||||||||||||||||||||||||||||||||||B
o||||||||||||||||||||||||||||||||||||||||||||||||||||||||||||||||||||||||||||||||||||||||||||||||||||||||||||X|||||||||||||||||X||||||||||||||||||||||||||||||||o||?|||||||||||||||||||||||||||||||||||X
X||||||||||||||||||||||||||||||||||||||||||||||||||||||||||||||||||||||||||||||||||||||||||||||||||||||||||||-|||||||||||||||||M|||||||||||||||||||||||||||||||||||||||||||||||||||||||||||||||||||||||E
B||||||||||||||||||||||||||||||||||||||||||||||||||||||||||||||||||||||||||||||||||||||||||||||||||||||||||||||||||||||||||||||||||||||||||||||||||||||||||||||||||||||||||||||||||||||||||||||||||||||v
E||||||||||||||||||||||||||||||||||||||||||||||||||||||||||||||||||||||||||||||||||||||||||||||||||||||||||||||||||||||||||||||||||||||||||||||||||||||||||||||||||||||||||||||||||||||||||||||||||||||T
T||||||||||||||||||||||||||||||||||||||||||||||||||||||||||||||||||||||||||||||||||||||||||||||||||||||||||||||||||||||||||||||||||||||||||||||||||||||||||||||||||||||||||||||||||||||||||||||||||||||X
?||||||||||||||||||||||||||||||||||||||||||||||||||||||||||||||||||||||||||||||||||||||||||||||||||||||||||||||||||||||||||||||||||||||||||||||||||||||||||||||||||||||||||||||||||||||||||||||||||||||E
B||||||||||||||||||||||||||||||||||||||||||||||||||||||||||||||||||||||||||||||||||||||||||||||||||||||||||||||||||||||||||||||||||||||||||||||||||||||||||||||||||||||||||||||||||||||||||||||||||||||-
o||||||||||||||||||||||||||||||||||||||||||||||||||||||||||||||||||||||||||||||||||||||||||||||||||||||||||||||||||||||||||||||||||||||||||||||||||||||||||||||||||||||||||||||||||||||||||||||||||||||?
X||||||||||||||||||||||||||||||||||||||||||||||||||||||||||||||||||||||||||||||||||||||||||||||||||||||||||||||||||||||||||||||||||||||||||||||||||||||||||||||||||||||||||||||||||||||||||||||||||||||?
m||||||||||||||||||||||||||||||||||||||||||||||||||||||||||||||||||||||||||||||||||||||||||||||||||||||||||||||||||||||||||||||||||||||||||||||||||||||||||||||||||||||||||||||||||||||||||||||||||||||M
XXXXXXXXXXXXXXXXXXXXXXXXXXXXXXXXXXXXXXXXXXXXXXXXXXXXXXXXXXXXXXXXXXXXXXXXXXXXXXXXXXXXXXXXXXXXXXXXXXXXXXXXXXXXXXXXXXXX-XXXXXXXXXXXXXXXXXXXXXXXXXXXXXXXXXXXXXXXXXXXXXXXXXXXXXXXXXXXXXXXXXXXXXXXXXXXXXXXXXXX
