--ToM----E---------------|M---?----E--ET---M|---T-M-o--?-------------XBE??B--E---E-X--|-To?------E?----o-?To--E?-T---BT-----o----T?----X-X-------------o-----EE--B--?-------E------T-?oT---M---|--oX----
-----|---M|oX-|---M-------?-T---Xo-----E-----T-E----BX----B-X-X-----B?-----------X-M|--E---M--o----B|oX---T-T-----E-ME---M-----E|------o-o----o--oX----?X------?----TX-BoMTM|B-E--|T--X-?EB-T---E--M-?--
--TE---o--------------------------X------XE?--------T?---------X-E------E-------T?-E---E?---|--X---|T-B---E------T--?B-----?TE-------TX----|-X--------?----------------------oT--B-o-----EoET---E---E---
--MB-?---E-----XM------|T|--BB------------To-|T--B----T?--E---------E-?-oE--T--MB--X----------|--M----?-B---EE|E---T-------B--T?--||----?o------M----E-B---T---M------M--Xo-TT-X-----M-X--EoT---B----T--
----?T-B?o---------|---B-M-?M---------|--E-|-|---X-|----?-EME---------TT-----?--E-------------M-EoX---E--o-----X------o-B--E------|o---B---X-----M--X----B-TM------T---|T--?|-----M-------B|-E-------ME-
-----------oXXT-----E----|M-M--o--M------?M------------o------T----BM------|B--------B----------X--?--?------B------X-M--?-------o|-??-E-----B-BX-o---E-X--T---E-------?T----|------BE--|?---o-----||---
---T--------E--o-o--M--BX-----BM------E---X--|XE----T-----M-T-|?T---T---------B-?E-?-T?--M---X--B---|?---------B--?-------M-M----o-oM-B-|-----TT---E--T---------o-----?--?------------|--X---|------E---
-----E|-M----E-------M-------?---E-o--M|----------X----------------E----------------T-------X---|-|------B--EXo---M--E--------TT----BT----BB--------E-B-----|o---?------|X-B-----|E-------------X------v
-X---T--X-B--------?-T--M-?--|-E-T--T-----o--E-----T---------------o-----E----|--?---B-----M------M---X-E--T---------MB----X-?T|-----T-oX---B----?----M------X--o----X----|-?|-E--|B|--B-T-------------f
------M--T-----T-MX-----------o----M--E-?-E-E-----TE--|o--?Mo------o------X---E------XX--T-X--E-|MT-----------oET---X-------EM-----E--E-------B-||----M-E---oX-oE----E----BB---------E----E--o-M-----Bof
-----------|-------M-------?E-----M----------------o---------M-----o-------ME--X-?-M-------X?---X-?-|--|------X|----------MB------T-T-E--------?---------oM--ME---|-----B-X-B------X---------?X---M----f
-----B-----E----Bo---oB-?|---T--o?----T-----E--------MB---------------T-M--EM--E---M--|-E---o----E---T---TT---T-T-oB-TM-T--?M--B----X-----E-TE-M||------------E----T----?--T--TM-M----X--?--|?B----|-o-f
--------M--------------------T-E|||--EB---MT---------E-----?-B--?-o------|---XXo---E---TB-o------T---B----B----T---B-X---M-----------M----T?-?--B-|-o--B|----o-----------oE--XE-?EMo---X--B?---ME--|oE-f
-------?--E|----M---E----M----B---E-MX-|o-T--?-?X-------T|-o-T--|XM?-------|-B----T-oB-----XE-------Xo--|X--B---|?X-X--B----------|--|oM--B---M---|----M---------o?-oE-X-E-B--M--B-------E---BMX----?--f
m-ToX------T---BE-B----M-?-------MTM----M-B-----?|--M-?-X---?----------?-|------T---T---T?-----|----M----M-M--E-----------TB-X------o----------------B-B--|T-B|--E---------|M--------------??-----|-MoBX
XXXX?XXXXXXXXXXXXXXXXXXXXXXXXXXXXXXXXXXXXXXXXXXXXXXXXXXXXXXXXXXXXXXXXXXXXXXXXXXXXXXXXXXXXXXXXXXXXXoXXXXXXXXXXXXXXXXXXXXXXXXXXXXXXXXXXXXXXXXXXXXXXXXXXXXXXXXXXXXXXXXXXXXX?XXXXXXXXXXXXXXXXXXXXXXXXXXXXXXX
