-E-|----X?oo-----E---|E----X?-E--?X-------T?--XE|E--o-|--T|-T---Bo---M--?--?----|------B-XM-?T--T------XE||---XE-|--E----B?T--?----TB-----?--T-BTX--EEM-B----E--o-E--B---ET--X-----E-B--E?----M--?|-Bo--
-TX|T-------B-BE----T?---X---o|----BT---||Bo-E------X--M-Eo--BB--B---TE--XM-E-XTMB-MoX|--B|-TT--o--M-||--ETEE|X---o-E-o-MoEMo-?----M-X--|----oT-----XoT-M--X--oBo----E-TE?----X--E-TXXoo--BE----X-?-o-o-
----M?MT--M-XE--E-T--o|-MTTMB-BE-M-o--X-|XXX-----------E-?-T-M---|-?--B---EB--E-E-o------M-M--BMX---|B--E-oB---XM||---X|M---|---B---B?-B-----E--|-MEE-?-X-?--T-XXBT-BX---B--?-B--o------T-?---o--?M---X-
--|-T---B-T---EoTX-?--ME--E-Bo---B---MT|------o-X---M-----?BEEo---M-?-T-?-B?-|-E---T-B-EXE----o-M-B-B-ET|-------X---oT-T|o-?-E--|-------o-T?-T?TX----?--------?-|-|oT-B-X-?E------|EEMoXE|X--BE---|-E---
-|--T---?M----X-|-MXBET-----o-?--MX-------BE---EB-M|--------M--MTM?XBE?---ETT------ME-Mo---TX--o-X?--o-BMB|T--oMX-?---B-|--?EE|-----MT----|X-T---BX----E--X-?|-E---M--T-X--MoB?-oo-|---oE-M--|-oT-X--E--
----BT|--T----XT-----T?--Xo--oBoo-XX-BMXX-----E-B----?-E--?--EX-?-M|--T?---|?----E-MXB--M-X-|oo-MM-------?XEB---oo-----MB-Mo------T|-X-o--o-TBEX---o-X-----TE--||-|-B-TM---M-o|----?BoB-X-oE---|-M---?E-
---?------oXM|?Xo|-MM------T-X|Mo?-?X-?-oT-ET-T--M|-?--B--M-MEo----M--X|-BT-|---o--o--------T-|-T--ooMT--?--TToX--TMT|--E---B?|?-------o--o-T--M--------M-TX-T-|-B-T----------T-B-|--||B-X---X-EE--E----
--?-|----XB-E-||--TT-XT----|TE-XB----|---M?----o|-----oT-----B-|X-oX---T----X--MB-X---B?|E--XMB?-X-M|X--T----BE--B|---X-E--M----T-|--|X-|-?|EBT---?B?|B-E----|-BM-----|--?-TXo|?--o--?-|T-ET----|-o-M--v
--M-oo--Xo-o-M|T--MX-TMoT-|-TTo--?T---oo-oM--T--T|---Xo-----B-o-?B----T---E--o---|----B-Xo---?---B-XX-M-X---M---XEoXT--B--MM--?--X-T-E|-------X----|X?-----MBo-??TTT--o-?B?-X|----M-oTToM--T--|T||B-T-of
-T-XT-BX--Eo?--X--X??E-B---?-?-?-X-B--T----T|-|B----T---TT-Xo?B------B------MBT-X----?---MX?T--MEBXE---TM--T?--B-----?T-|E-T-E---T-?M---?oB--------M|--B-E---X?-EEo---|-?-X----||?-Eo---E|T-TBX----|o--f
-oX-----X--B-B-E-T-T-o-?--?-B--Mo-----oEEB---|TB--E---MMM-MoBBoB--XEM-EMB?---?-oB--|---M-?M--------MT|-B--MMX-E-?--o---oX-----T-ME|-?|BTB---o-B--T-o-X--?XBX--E---||-EE------|XX-EE-M--X|---|-|---|M--of
-|--B---?---|EX-oB--E--?----T----E-----XM-B-|---M---|-|----T-B---o-oo-E-To---T-|METM----E---o---oE----XE--E--|-ET?-X--M--M---X--oT----X-X--|-B---B---XM?E--E-||--o-E----BB----TT---B---?-M-?-?--?-M-?-Tf
-MX----M|E?B----T-XXE--E--ooTEToX|X-EoB---oM--?TB|-?M----?--M-MMB|--o|EX?BE---||B-B---XT-X-?T---?----?E?--TBE-M--?-E--X-TX-X----BE----E|E---XM-|-M|B-oT?---E-|-E-o-------T-X-M-|-----M-BBo----o--X-o-X?f
-------T-X----|-Eo--X-MB---EBEBM--Xo?-X--o--Bo-----ET-o||-M----M--|?--?--B-?-----X-?M------Eo--TXX-?T-M---B-MM--T-M--TT?--M----?--X-EB--o---o---|T--B-E-X|E--ooo?o-T---MT?X|E||--Mo-?----|XE-BTE---B--|f
mB|------?E-M---oM---o---?X-X|M-|-B?T-X-?--MT?-----MBM-oBE-ooX?----BBX-?--|---?-?XTEM-XE---?-o----?T-TE---X-E-----XE--?--|-o|-??-o-----o--B-Bo--T--XM|-?TB--|-|o---------MT-?|--|-E---T|--E----MM--TB|BX
XXXXXXXXXXXXXXXXXXXXXXoXXXXXXXXXXXXXXXXXXXXXXXXXXXXXXXXXXXXXXXXXXXXXXXXXXXXXXXXXXXXXXXXXXXXXXXXXXXXXXXXXXXXXXXXXXXXXXXXXXXXXXXXXXXXXXXXXXXXXXXXXXXXXXXXXXXXXXXXXXXXXXXXXXXXXXXXXXXXXXXXXXXXXXXXXXXXXXXXX
