----M-|-MEB?---M-E-TM--X?-TM-B--o-?XX-||oB-o-E-ETB-T-B--B-T-M-E-T-B-MM-----?-?---M---o|---||o-?T||--T-EB-M--?-----B--MM----ET|-E--MX-X-|--T------|X---X--XX-BoXTT--?|X-BTM--B-E-E--M-X-|--|-?B--|---B-M-
-----T-??BTEX--TM----|----------B--B-E--|?--B-||---|-----B--o-----X-TE---oET--E|?T?-ET-?|B-E-M----BTM--oEo----EX---MBM-X-|-X-------|o?T--|--|-T|-----ET--?|?-----?o--BTXoE|-----oX--M-X?M--B--ET-----MB-
-----B----M-BM----TT-TX-?---o-B?M---TB?oX-E-TE----ET-?-Eo---o---E-?----oT--X----ET--?-o-MX--|M-EB----M-M-BE-----T-|T|-o---o---?-----To--o?---E----B-B----TT--T---M--?E-|B|oBM--?E-B---X?-?o|---------EM-
---?-XTM|-TM--?ToX--TB-o-?---E?-E---B|----|B|-?T|-?-oTM---T|-?X---E--E?--B-?T---M-?oE---oM--MT-----M-----M-X-XMM---?-----|--o-EB----|?M----o--oTMM-MX----E------?-?--B-E-X?E-X--o----TB----M--------E---
-M---BXTX--o-o|E-?oT-------M-X-o?--X--XT|----?----?--------o|-E-X-o---TX--?X-B---|---o|--BB?|----X-?XTo-X-E-TX---oo?BTB-?---Xoo|M-?----|oTT--TE----?-?--|T----X-BEM|X-o-MBEB-TX?--?---T---EE----X--o-?--
--M-E--B-----B-?|---BTX--?-X--M-T---------B?-MX-M--?oBB-BBo--BoM----B|-To----ooB|M--?--?-T?|o?--XE--|--o-XM----EM----o----B-?X-|-EM|X-E-M|XX-------T?M-B--E--B--E-T---BT--|--To--X?-E-MX||--T---X?-MBXM-
--Xo-X-X-XBB----B-||----M-BXXBoXo--B--XoB?-?--|-Mo|-?--EMT-|-B-?XX----T|BM?---E-|-BT--E--?|T----?o-BE-?------?--B-M----XBM---Mo---E---??------T-X---|--XX-----?--Mo--X--M?---Eo-XoM-X---o--X-?---X--|-|-
-Mo?MM?---?EMXE---X----B----||-o-TM?o------B-E-?-----EX---|Mo--?--B--T---X|XTE----?-----oM-EX--|--X-XXM--B-|--o---EBX-EBE|-?------|---M|o-|-T?-|--XT-----B-oXT---ooB-Mo-----MMTM--||Xo-BB-E?E-E----XX|-v
-XoMo?---X-------?--?-ME--E-------X-|-----BM-oM?------|X-|X-|---E|E-B-MM------T-BB-E--BETTT-T--oX-EX---?XB--E-|--o--BTM------X--|o|-TX---M-|-T-Eo--Eo-X|---B|--E-----o--------oXo--oM----T-|-XE--B--EX-f
-M---?XT||Eoo-o---B|?---X-|B-----?--E-E??-----|-B-X-T|o-XE---ETT?-EBX--|-X--XE-T??B-o-|B----|---E-----o-|---?-|---E-E|------X-?-M-X-E-?---To||----|---E|-----X---E-o--BM-Eo--oBB-----ET----X|B?------?Ef
---?E?X-X--?E---|-|M-|B-E-E-------o-B--?T-----------|E--|---o|MBEETT---M-T-M?X|T?-M-----B|oM--X-----?---?M--E-----M--E-?E-o--oEEM--|-X--oB----o-B--------?--o----EET--------BX-M---------?BE-M---B-BT--f
-X?T------o-----|-T-M-??----B|B--o---B?M-B-B-------Eo-XTT|-TM|--BE------B-E--X-oT-------M-TB-B-o----B|--------M?To--o---XB-|?E|-X-----M?--o-o--?-|--|-B--TXX---X|BTT-Mo-M------?-??--Eo|-?E-----|M-----f
--|-EX---EE?-------X-X-M---|--B-M------To-MM----B|---------E-M--BT---MX--oB--?TMBo-MB--EB-T?X-E-?-|--T--EEo---------E-T---?--X-E-----T-T--B-o-T-?--X?-----M--MT--o--B--X-X?XX--MB|X-o--T----MEo--EM|---f
--X-T--|M-o|M-?T---o?|--?---B-??|--oM-X--EBT-ME--?Moo|-T--Eo?---TMXTMM-X--?E--o-T-B-X-?----|-oE-|oE---T--|--T-o---o-?-------M-----?--|-TTX?--EE----|X|-?|--T--o---oX-E-|--|-X-o--o--o----oB----|---BXX-f
m-o---B-?|-----o||---T-|--|-----|T-|--X----X-----M--oME--||-------BX-M?B-TBo-|BM-XB?T--B--T-E|?-?|o--E-T|X----E-T--?-B|-|o-M--X?M----|-|BT---X--?M-B---T---E-T---M-T-B--BMB-----X----E|-E--B|----?---XXX
XXXXXXXXXXXXXXXXXXXXXXXXXXXXXXXXXXXXXXXXXXXXXXXXXXXXXXXXXXXXXXXXXXXXXXXXXXXXXXXXXXXXXXXXXXXXXXXXXXXXXXXXXXXXXXXXXXXXXXXXXXXXXXXXXXXXXXXXXXXXXXXXXXXXXXXXXXXXXXXXXXXXXXXXXXXXXXXXXXXXXXXXXXXXXXXXXXXXXXXX
