-B-------To---|MEE?--|B--T--XMT--oE---XTB-o-T|M|-E---|--|M----oTMX-E--BMBM---TEo?--E|B-B-BoM-?X--?-B-EB-XEo-?--B---X--|-XT-?-?-o?----BB-B|--o?-?-X--oBB--||--|--?-MM?X-M?-X------X?-B?----?BX--o--BE?-|-
-?--EX|-M?-E?X---o-o--M?--??-|T--E------M-?----MM---TB-E|--o----?o-T--B---EBB---------E-----?B-XX-?----B---o-?-T-T-X--MX-T----M-XoEB----Mo-X----M|?BM--?-M-?o--?|E-|??-----|--TE-?M-B-E|B---MET--E--?M--
--?--|-|-EM--oMX-o-----E--E---B-T--MM--T---X|B-B-X|E---T-XM-o-M|X?-X-----o--B-oM|-MX--BMX-ET-M|------|-|-TM----T----X|----------?ToTT-M-T---EoX-B--|----o-B--TT----o-|---?X-T|-EEE?Eo-M-----E-----T---E-
-|X---E-?-----T----T--o--|-Bo------M---M|-XX--oM--XX-B--ooooX----E--|-ET|-o---?B---o-M|E-M-BB?--X-|T-|---?---XoE--|--M-X-T----ET-?BM?X-o?E-oT---Too-X--B---MEo|--B---oB----?M?--B--|B|---|-BE|--?oXB-T--
-BoX|--|--B--T-E-Mo----|T--M-XB-|oBoooB|--M--T-oTXM-?XM--B--E------B-o--M-E-B-Bo--XBTM---o---M?-T------o---T-M-----|oE-|--B-?B---X----|M----|E---EBoM-EMT-?MB---|?--------|To--oX|EB-X-?-M--T--T--T|-Xo-
----B--X|o?---oX-B---T---------||-----B-MXE---X--o---TT-Xo------E----?-E--Xo-?M-BX--o-B---TXE-M-T----|-?B------T-oB----?-?-E----oM--X--M-----o--X-o---E-B-X--M?----?-T?B-BM??-E|XB---|o---?B|--oE---|oE-
-o-E?-X--TET----E------B-M-XB-X-||-M-Bo----T?M------XM------?E--o|E-T--E-----?-ET|-----TB-|-|-|E---?BB-|X----B---Eo-oEX-EB-?---|----E-----M---BE-To--oT------MMT---?-MXEM----M-E-EMoB--B---o--------|o--
--X-E--T-|-MB?|-?B-Too-T----BX-E-|-?--|M-T|---T----B----X--MoT--oME|--M?-----XEX?-EXT?--BXB--T?--E-|-?-TEX-----T---------|X---ET--?--|o--||-oB---M--TB---To--Xo--XX--T|o-Bo--oE?M--?M-----B--X---B-M-BBv
-------E-X-TBoM--X---X-o-|--X|-X-EM|-o--X--X|---TM-|B-ETE?T|E----oB|B-oo-?--EBE-X---o?-TT-X----BoX--M||M--|M---------|-?B--X---X-B--BE-E-EEEX-|-EX---XM-|-EE---E??-|--|-?-T?-o-?E-?-|-M-----B----X|--BBf
--|----E-----X---EMoo--B-MoX----EB-T-X|---T--|-|---X-|-?------oT-----X---|-----M-?E---oT--X-TM-B---E-B-?--|----?-?--|T-----------X-----M----X-----B-|---?--|ET---------------|-?---o-B|----MB--|-TX-o-Mf
---?--TXMo-T----T--?o-M---Mo-BBMB-M--B--M-TBE|E-T-T-o-?-|---B-M-X-T--B-X---M-|M--?T--T-----------TE--|--|--T--|--o--|-T-E--X-?-?-----?---M---o--oT--M-E--X?Mo-o??-?--o-------M-?B-X-----|--E----?-T?|--f
--------B--oM?TM----M-Xo--X-BB-T?----TX---o-T-?-B----BooMBMT?-B-|--?---E-BMXoo----|X-------XM-MX--|M-TE--XMo-MT---|---E-?X--TB|o-MB-??M--?-T---?-|o-TM-B--o------|---MB-M-?-o?To----X?oB?X---M--||-EoMEf
-|X-|-?----X?EX-|-o-----XX---B-M--T---?--M?-E-Bo-----|-BEB-T-T|-E-Mo--T-?E-?--?X-T-----oE|X--M?-X-X-?E---X?-Eo-X-B--M----oT-BT?TB-M|-MEB-BXT-E--?--T-EMM?XXXE-E---M--XE-MT-TX--T--EE-|---T-X-?-?--BMo--f
-XT?BXM----X?o---o-||E--o--X-T--|------?|-o--T?B-?EX-BB---M--M||o-M-?---TT?B-----|T-oEXB-T||-B--B---X---|o|?-MB|--Bo-E-||---?----??----B-----T---?-B---oB-B?--|XTEE---MT-?-o---------|?-TT--To--T------f
mE-T---o--MTo-B--o--EBB-|M----|--X---E-B-E|---------oXo-|B|M--?-Eo-E--M--E---T-----|-M-?-?X-BM|-?-----E--XT|--?M---EE|-E---Eo-XB-o---?-X-B-o-E|--o----Too-|B---|-E|T?|-X---oTo--XX|-M---o|ET--?----|X--X
XXXXXXXXXXXXXXXXXXXXXXXXXXXXXXXXXXXXXXXXXXXXXXXXXXXXXXXXXXXXXXXXXXXXXXXXXXXXXXXXXXXXXXXXXXXXXXXXXXXXXXXXXXXXXXXXXXXXXXXXXXXXXXXXXXXXXXXXXXXXXXXXXXXXXXXXXXXXXXXXXXXXXXXXXXXXXXXXXXXXXXXXXXXXXXXXXXXXXXXX
