-o------E-T--M----------|---?---E-XE---M---------------E?--M---------?-B-----?B----|-----?-----------------??-?-----------M-----------?--MXB------T-M------------------------E----X-------M--o----------
------M-o-|-------------Xo---BB---------?------------B---------M-E-----B-o-------M-X------X-----------T------?----------o-X-------X-----E---------X-----X----X-----X-----------o------M--M-------B------
------X---M---M?----o------T----oo----B--B---TB--M-X------BoM------B-?----M-----------o----------T----X---B--------Xo----------?-----M------?---?B------------M--M----------------?-?----X-------B------
----?------------X-E-------M--X-----o--------|---?EE-M----?------o?--------T-M-------------------|---M---------------M---------?-----------------?M--M---------E-?---T---------M---------?--?----E------
-oT?--X--------------?--------E-E---X---X----X-?------------------?--M-----M-----B------B---B--E-M-----M------------XB---B-?--?----?--------?-B-X--M---B----------X-??----B---?-----o----?-M--------o---
--?------X-MB------T--M----------B---T---B----------E-----------X--M----B-?--M-----------------Bo----?-X--------B------o-----EX--------?---B------X-----------B-----To-----M----------------------------
----M---?--------o-M---------X-------M------E---------?-----X-----E-------Bo---X-o-----------X------X----X-------T------------o-------------------M----------?--X---B?------------------X-----XE------T-
---MoX--E------E--------------T-------B---B-------------o---X--------M--------M-M--------M?-E---X---------M----------M----------M-------------------E--------M---------------o?M----B----------BM-----?v
------T-o---------------------X--o-M---------------------------------X----B------------------XEX-------------------?o---------------?---X-----E-B-----------M--E-------BE---------?-o-----Mo---T--X---?f
--X---|----------o-----?---X------------------------EE------------------E---oEM--M----?------------------T--------------?---------B-----------E-------------------o-T?-B---o---B-?---o------?--M---?--of
---E--X------XB------o-----?----X----------------?--X--------------------E---o--------B----Xo-T----------?--------X----------E------BB-------------X---------T-B----X-----M------X---B----B------------f
---------------X--MB--E--M----B-----E--?-------?-----B---?-T--??------o----X----B--X----?---B-?X---X--------------?----------o------T--X-----E--B------------X--E---?---------T--------B----B---------Ef
-------T-------M----------------------?-------------M------M----------------E--------E-----B--------------------MB-----------o----o-|X----M--Xo-------B-------o--o-?--o-------X-?--o--T-------------M--f
-----E-X---------------E---B------B---BM-B-B----------??-?--------X----------------?------o--BT----?--E-----?------X-B-?-B--T-----M-|--------B-------T--X-------------?M-?------------X----------------f
m-T----?------M-T------X-E-----X--T---T----M-XM--T--T--X---M----B---X--XBMo---X-----o--T--?-E-B---o------o?----------E---M--B-----M-B-X--------------B-----------------------T----M-------?-oB-o-B---X?X
XXXXXXXXXXXXXXXXXXXXXXXXXXXXXXXXXXXXXXXXXXXXXXXXXXXXXX-XXXXXXXXXXXXXXXXXXXXXXXXXXXXXXXXXXXXXXXXXXXXXXXXXXXXXXXXXX-XXXXXXXXXXXXXXXXXXXXXXXXXXXXXXXXXXXXXXXXXXXXXXXXXXXXXXXXXXXXXXXXXXXXXXXXXXXXXXXXXX-XXX
