-o----E?E-T--M----------|---------XE-------------------E?--M---M-------B?----?B----------?-----------------??-?------E------------E---?-----------T---------E---------------T-----X----------o----------
--M---M---|-----------B-Xo---BB------------X-E-------B---------M---------o---------------?X-----------T------?-------E------TM----X-----E-?-------B----------?-----X---?--o-B--o------MM-M-------B----o-
----------M----?---MoX--------T-oo--B-B------------X---------------B------B-----------o----------T----?B-E---------E-M------X-----E------X------?-------------M--------------------------X--------------
-----------------X----?----?--X---------T-----M--?BE------?----X--?------?---M----------X-----------XM---------------M?--------?-X-----------B---??--M---o-----E-----T----T--------------T--?---?E--o---
-o-?--X--------M-----?--------E-E---X---X----E-?--?---------?-----?--M--------------X---B--MB---------------M?---?--XB-----------M-?--------?---X-oM---B----------X-??----BB--?-----o----?--------------
--B-----M---B--o---------------B-----T--------------E-E---o-o---------B---?--M-X---------------Bo----?-Xo-------------------o?---------?---X------X------E---EB-----To-----M-----------E------------?---
----B---?--------o---------------M---M------E---------?----?X-----E-------Bo---X-o-----------E------X---------------------------------------------B----------?--X---BB------B----------?------XE------T-
----?X---------E-----------E--T---------------X---------oo--X---B----M--------M-M-----------Eo--X---------M----------M-------------------------X----------B--------E--------Bo?M----B----M-----BB-----Xv
------T----------E------------B-?------B----------o--M----------?----------------------------XEX------B?-----------?o-B-----------------M-----E-B--------?--MB-E-------BX------T-----M-X--M---oTX-X----f
-EX---|----------o--ME-?--------T---------------M---EE-----------------ME----E---M----?------o------B------X----X-------?-----B--o------------E-E---X--B----M---T-o-T--B---o-----?----o-----?--M---?---f
---EX-X------XB---T--o----------X----------------?-------E----E--oE----------o------------M-o-T--------B----?---------o-----oEX------B--------------------------M---X----------------B-----oM----B-----f
---?-BB--------X--MB--EX------B-----------M----?--------------?-------o------B--B-------?--MB-|----X------M-------?----------o---------X-------MB------X-----X--E--------X----T------E-B--E-B-E--------f
---E---T---------------B----------------------------BB-----M-----X--------?-E--------E--------M-----------------MB-----------o-------X-------Too--------------oE-o-?-Eo--T----X----o--T--B----------M--f
-----E-B---------------o---B------B---XM-B-B----------??-?-?--------------------------o------------?---------------X-----B-------o-----------B-------?--X------o-M-?-o?--?------------X----?-----------f
m-T----?---?-T--T------X-E-----X--X--------M-TM--T--T--o---M----B-?-X--X-Mo---X--------T--?---B---o-TT---o?EMM-----------M--------M---X-------------MB-------------B------------XME----------B-o-B---X-X
XXXXXXXXXXXXXXXXXXXXXXXXXXXXXXXXXXXXXXXXXXXXXXXXXXXXXXXXXXXXXXXXXXXXXXXXXXXXXXXXXXXXXXXXXXXXXXXXXXXXXXXXXXXXXXXXXXXXXXXXXXXXXXXXXXXXXXXXXXXXXXXXXXXXXXXXXXXXXXXXXXXXXXXXXXXXXXXXXXXXXXXXXXXXXXXXX-XX-XXX
