------------------------------|-----------------------------------------------------------------------B-------------------------------------------------------------------------------------------------
-----------------------B-----------------E---------------------------------------|----------------------------------------------------------------------------------------------------------------------
------------------------------------------------------------------------------------------------------------------------------------------------------------------------------------------T---X---------
----------------------------------------o-------E-------------------------------------------------------------------------------------------------------------------------------------------------------
------------------------------------T-------------?--------------------------------------------------------M----------------------------------------o----------T----------------------M-----------------
-----------------o-----------------------E----E-----------------------------------------------------T-------------------------------------------------------------------------------X---------------M---
--o-----------------------------?----------------|-----------------------------T--------------------------------------------------?---------o--------E------------o--------------------------------M----
-----------------------T--------------B------------T---------M-----------------------------------------------------------------------------------------------------?-----------------------------------v
-----------------------------T-----------------------------------------|-----------------------------X-X-----------------------------------------------------------------------------o-----B-----------f
-------------------------------|----------------------------------------|-------------------X----------------------------------T-------------------------X---------------------------------------------f
----------B--X-----T------B------------------------------------------------------?----------------------------------?----------------------------------------------------------------------------------f
------?-------------------------------------------------------------------------------------------------------------E------|--------------------------------------B--------------B--------T------------f
-------------------------------------------------------------------------------------------?-----------------------------------X------------------------------------------------------E----------------f
-------------------------------------------------------------------------------------------------------------------------------------------------------------------------------------------------------f
m-------------------------------B----?------------------------------------------------------T-------------------------------------------------------------------------------|---------|----------------X
XXXXXXXXXXTXXXXXXXXXXXXXXXXXXXXXXXXXXXXXXXXXXXXXXX|XXXXXXXXXXXXXXXXXXXXXXXXXXXXXXXXXXXXXXXXXXXXXXXXXXXXXXXXXXXXXXXXXXXXXXXXXXXXXoXXXXXXXXXXXXXXXXXXXXXXXXXXXXXXXXXXXXXXXXXXXXXXBXXXX-XXXXXXXXXXXXXXXXXXX
