------M--------------------X--------o---?-----X------o--------o------------??---------?--------M-----------------?-----X------------------X-----E--o----X------------B---------|--E---o----?------------
---------X-----?----------------E---M-----?-----E-------------------------?------------o------------o-XX---?-----??---E------X---------------------?---X-M-----------E--o------X----------------E-------
---------------------o----------------------M--------------?---------E-M--B-------------M-------M--------XoT-----E---X----------X-?---?--EXM--o--------?---M----------------------------------E---------
------o----X--X-----o---E---------M--B----------o-----------------------?X---------------------------------M------------------------o--------X-----T-----------o-------------X-----?----?------------T--
----T----E----B------------M-----X-----X?--M-B--?----?---?---X-o-X--BE-------------------X-----------E---------?-------Bo-------------B---M----M---|-----X----o-------B----B-X--M---?--------o--XM-B-?--
----B--E------------?--T-X-------X------?--X-----------B-B---X---X----------B------o-----------------------B--MMX-X------B-?----M--?--------M--E---X-----------------M-M------X----EB--------------o----
----X---X-EX--?-------MM--TX---------o----------------------XoET--o---B---E---X--M-?---?----------------T-M-----?------oT-----X-----------------M-M-B?--------X--oX---X--------------------B------o-----
--------------X----X------?---------X?-------------M---------B-M?-----------------------EB-----------X--M?---------M----M-------------E--------o------------------o-----M--B--X--------X?M----------o--v
------------X-------------o-------M------X---E--oT-M-T---M----------o----B-------------------o-TB-----X----X-------------o----o-----------------o-o---------X-E----------E-M--------------B------------f
----------------------MB-M-?-B-----------E------o?o--B------o-----------?---------E-----?-M----B----o-------------o-X---X------------E----Eo----------XE---------X--o----XB--o-?M----E-B-M----------B--f
--------B-o---------E---X--------M-?---B--------------MB---EX--XB-BX----------oo---------------o---oE--------B---?-o?---------?-----------------E-----------E----M------------E------------------X---M-f
-------?-------------?-----E----------------------------------X-------o---------X----------o--?--------------------------o-----M------X--E--Mo----------T--------E-----------X----------X-E-----------Bf
-------------------------------------------------------------------------------------?----------o----?----B--B---------?----------------------B--------o?---?----X------------E-E-------------X--T--E--f
----------o----?--ME-M----------o-----?----------------------------------------B---------------------------B-----o----------------B------EB-XE------------------X-------------------------o------X-----f
mEM--------T-----------T-E----T-----E-B-------T--T--------M--------o---------M------------------------------B------------?----------T------oB----M----o-X-------?--------T-----------------------?-----X
XXXXXXXXXXXXXXXXXXXXXXXXXXXXXXXXXXXXXXXXXXXXXXXXXXXXXXXXXXXXXXXXXXXXXXXXXXXXXXXXXXXXXXXXXXXXXXXXXXXXXXXXXXXXXXXXXXXXXXXXXXX--XXXXXXXXXXXXXXXXXXXXXXXXXXXXXXXXXXXXXXXXXXXXXXXXXXXXXXXXXXXXXXXXXXXXXXXXXXX
