---------X----------X---T--o-|-------?------X?-----M-?----X-|E------M--------oB--o---|----M--E---M------?---ET---M--oB------T-?-B--------------X|--M---------X--X---B--T----MMEE----------o-B----TET-MT-
--M---E-------?-?T---BX-------B---|oE----Xo----X-o------XXTT---X--|---X------T----?---------o---------------------TX-----B-E-X-X-|----------T--T----X-----------E-M--?--EE------o-----B-oMT-----To-?----
---------o---X|------TTE?--BT-E----o-M-BB----M--------?-X-----------X|-------Eo---o-|--?-------------M---------X-E----------X---TB-o--|B---|---|------M--o-X--MX-?-XM----?-?|----oX|---XEo---o--X-------
-X------E-----E--o--E--MoE--BM--XX-B-----M----------M--B--T---------------?--E?E----X---M-E--B---B--o-?--o-|--------M-o-EE---EXoE-------------------T---ME---E----T------?-M---X--T----M--METB----T--|--
---------TM---|E--M--ToM--XX--------|--B-|--oBE-----M---|------XM----XX----M--o------o-----X-?---B---?ET---Bo---------------o-----M-----------X--o----E-?-|--o--------B---M--|---------?--M-o------M--M-
--B---E?MX-o---?---T?---B---------E?-o-------------X-B-----------||?-----B-X|-------M-----EB------B----T-------T-o--X?--X--XB-MXEoX-M------M----E--T-oE-E?-o--?-T-X-----X----------------?-?---B--------
--BoM----|----oTM---B---?M--o-|---|-------X--------E-----?-E---B----------------B--BBB-E|--------------X---X---?------M--B--------?--M-----?---------X----E-B-|--o-------------o----T-?-o---M----XT--M--
-?--X-ME-E-TX-X----MT----------EX-|-----o----E--B---X----?-------EE---BE--------B----X-?|T-o-----------|----o--??---M-------M--------?-----Eo---------------oB-----X-?o-------------------o------------v
--M----M-E--T--T----T|-------------T-------X---X---o-TM-----E?X---------M------?-M----|--|----E----M--o-E|------------B-----EBE--o----B-|?---T-T-M------|--E---B--M-------B-B-------|--M|XB---E?------Tf
----o-----?T-M?---o-E----M--------|---oB--EM-T--?---MX------M----------o-B----T---------o|E-T-TX--EM?-------|MMX-?-o-M--------Xo|-----B?------|-?E-B----------To----X--------E--?---E--o-----T---------f
-M--X---MXX------X-----oB--oX-----------|---oBM----X-------------M|----XEX-o--|X--B-B----o?-----B--------|--M-X-----B-------M-ETT-M-|?--?--|------B----M--B----M?TM-?---Xo|EX---M--o--?T------------B--f
---E?--B---X--------?-X-E----------B----MM---|--|-M-|B--o-o?---EB------?-B---oB---oM-T--oo----B?-------E------------X-------To--B---|B--o----MM---M----XEo-E---oT-Eo--------M----o---T-?-X----T----E--Mf
------?--B---?-E-M-M---------?-X?--|T--EBT---X-oo--M------?----|------B---------E---------T--------MoXM----M----?-o----M----------M--?---B-T--ET---MX-T----M--M-E--E--?T-X----X------------o----B-|-X-Mf
--o--X--T----M--------?------T----------B--M|o----E------B-E-o-------------E-----E-E-|B---------?T-----------------M------ooB--B-------BM--E-B----------?--------TE--X---M--oETTXTE--T--B--E--?---M----f
m---M-----o--|----X-?-E-T--T----MX--EMM-------------?---B---XX---|--M-M---?-----T--|?T-----?--B---E--E-M---B|BT--?M------MoT-X-------|o--M-T---X-M-?E-T---X--T-E-----B---|---|-M-T----TEX-----|--T---EBX
XXXXXXXXXXXXXXXXXXXXXXXXXXXXXXXXXXXXXXXXXXXXXXXXXXXXXXXXXXXXXXXXXXXXXXX-XXXXXXXXXXXXXXXXXXXXXXXXXXXXXXXXXXXoXXXXXXXXXXXXoXXXXXXXXXXXXXXXXXXXXXXXXXXXXXXXXXXXXXXXXXXXXXXoXXXXXXXXXXXXXXXXXXXXXXXXXX-XXX-X
