-MXMB?B-?oT?oXEEM-?BBTETo?-BEMXMBXoX-|oTM??|T|-XE|B-Eo|T--?|BBMoXM|XBE-XM?|oTXXBToETTXM?BMMXMEBo|--?EBXoEEBXBXo-M|||?TM--MT|T|XM??|M?XXXoMXE-BE|o|?BBMBoBX?o?BEXB--MB?oE?E-X?XMM-|X|-EMBX?X?|oBM-oo-TTEM
ooM?X|o||M||E-B|-|M|o|T|||oM|M--EBM-?|||E|||||TB?||??X|||B||o|BE-o|-|?||||||||XE||||||B?MB|T|||E|X?XoMM?ME||MEB-|||||||B|E|||||BM-|?|EX|TB?BBB||B||?Bo|oE|-|X|?o-?BMM||||B?|T||XE|||BT?M?|T-|||-TTXT||TB
?E||||||||||o|||X|M||||||||||EMM||EE||||T|||||||B||?|||||?||X||?|o|||-||||||||?||||||||||||||||-|TX||?||||||X?|B|||||||M|||||||EEE|||-X||X|B||||M|||||||||||||||||XB||||||||||||||||o||-B||?|||-||B||||B
E|||||||||||B|||||||||||||||||B||||||||||||||||||||||||||||||||||B||||||||||||T||||||||||||||||-||E||||||||||?|||||||||B|||||||BE-|||TB|||||||||M|||||||||||||||||XE|||||||||||||||||||Eo||E||||||E||||?
X|||||||||||M|||||||||||||||||E|||||||||||||||||||||||||||||||||||||||||||||||||||||||||||||||||||M|||||||||||||||||||||||||||||o|||||||||||||||||||||||||||||||||BX||||||||||||||||||||T||||||||||||||B
o|||||||||||B||||||||||||||||||||||||||||||||||||||||||||||||||||||||||||||||||||||||||||||||||||||||||||||||||||||||||||||||||||||||||||||||||||||||||||||||||||||||||||||||||||||||||||||||||||||||||X
X||||||||||||||||||||||||||||||||||||||||||||||||||||||||||||||||||||||||||||||||||||||||||||||||||||||||||||||||||||||||||||||||||||||||||||||||||||||||||||||||||||||||||||||||||||||||||||||||||||||E
B||||||||||||||||||||||||||||||||||||||||||||||||||||||||||||||||||||||||||||||||||||||||||||||||||||||||||||||||||||||||||||||||||||||||||||||||||||||||||||||||||||||||||||||||||||||||||||||||||||||v
E||||||||||||||||||||||||||||||||||||||||||||||||||||||||||||||||||||||||||||||||||||||||||||||||||||||||||||||||||||||||||||||||||||||||||||||||||||||||||||||||||||||||||||||||||||||||||||||||||||||T
T||||||||||||||||||||||||||||||||||||||||||||||||||||||||||||||||||||||||||||||||||||||||||||||||||||||||||||||||||||||||||||||||||||||||||||||||||||||||||||||||||||||||||||||||||||||||||||||||||||||X
?||||||||||||||||||||||||||||||||||||||||||||||||||||||||||||||||||||||||||||||||||||||||||||||||||||||||||||||||||||||||||||||||||||||||||||||||||||||||||||||||||||||||||||||||||||||||||||||||||||||E
B||||||||||||||||||||||||||||||||||||||||||||||||||||||||||||||||||||||||||||||||||||||||||||||||||||||||||||||||||||||||||||||||||||||||||||||||||||||||||||||||||||||||||||||||||||||||||||||||||||||-
o||||||||||||||||||||||||||||||||||||||||||||||||||||||||||||||||||||||||||||||||||||||||||||||||||||||||||||||||||||||||||||||||||||||||||||||||||||||||||||||||||||||||||||||||||||||||||||||||||||||?
X||||||||||||||||||||||||||||||||||||||||||||||||||||||||||||||||||||||||||||||||||||||||||||||||||||||||||||||||||||||||||||||||||||||||||||||||||||||||||||||||||||||||||||||||||||||||||||||||||||||?
m||||||||||||||||||||||||||||||||||||||||||||||||||||||||||||||||||||||||||||||||||||||||||||||||||||||||||||||||||||||||||||||||||||||||||||||||||||||||||||||||||||||||||||||||||||||||||||||||||||||M
XXXXXXXXXXXXXXXXXXXXXXXXXXXXXX-XXXX-XXXXXXXXXXXXXXXXXXXXXXXXXXXXXXXXXXXXXXXXXXXXXXXXXXXXXXXXXXXXXXXXXXXXXXXXXXXXXXXX-XXXXXXXXXXXXXXXXXXXXXX-XXXXXXXXXXXXXXXXXXXXXXXXXXXXXXXXXXXXXXXXXXXXXXXXXXXXXXXXXXXX
