-M??|--E--?|--E------X?Eo--?--T-??X---M--B--|--E-----o-oTEM-Bo|XX-ToX---?--oo-M---|-|-T|----Boo-ooM---E--------XM-|-E--E-E?X-TE?X---o-EM-M---T?---EX?---MET-BMMM-B|B-To-X-E-BEEE-TXo--|--B-M-?--E--M?---
--E-X-------oTEX|------?----EB-------|EBE--X-?---BBE----E---|----?o--BE?MBEEM|-oT--E?X-o-?|M--MBBE-o-oT-TMMMMB--E|X?X|------T-B-|---|oo-oE----XoXXMo-?--?---B--?B-B-----------------B-|M-?TE--B-----B---
--------B-T---B?---X-X--ET---BoE---E?-M--M---XX-B-M-TT--o----TB--TX-|-----BX--EX-------?X?E--|--XMMB--B|E-X----?TTE-|--o--o---T---?--|--T-B--o--M-?-M-Booo---XToM-M-E?------|----E--|E-T-X----E|--|TT---
----?-M-B----oE--M----?-M---?o--X--?o|-T---EX-EX-X-?X-T---X---E--?X--?-X--TT--XM--B-----T-||----T--T----E-----X-?--T--E-|-?----M-------E-T---MET---T-XoE--M-M-E----o-ET---o-|o--M-?------X-MTE--?-------
-?-TX---ETM--E----M-E?-X-E?-B-oTB--oX|?o---|----o---T--EX-M-?--M|X?T-|-XB--X-?----?B-|BEo----E--??--TE-oB--|X---X---|X-oEoE---M--T-?-M--BX-TME---|o--------T--X--T-Bo-oBM--EETX---?-B-BXE-E-EE-|M---X---
-o-BX|E--M--?E--B?T?Eo?-X--B?-B?T---MB-X--|T------|-||??---?B-MB---B-BBB----oTX-oM---T-TE-o----E---E-------ooB--TE-XMo?----o--M---E?-|M-oXoXEX--?----|-o-X--E?X|oo--|X-E-?--|E-?X--EoT?-------oo?-|-----
-E--?--|-X-?-|--T-----|--EoX-T-T--B-TM-??o-?EooEM-o-EB---E-|MXBE--B---T--?-------M-|E-|--?---X-T-----?----?--XB---X-B?---|--B-T-E-T-?-EMBX?|B-M--M?M-MTo-TE?M?-Xo-B--??----B-M?--o?--o--|--TX---?-?X----
-M---?oXo---Bo-|---B||---T-T-MEo?-|-o-E--oT-T?MB---?B----X-------BX-??-T-?TE--T---BX--T-|-E--XE-|--XoB--o---B---X--T-E---?o?-E----B--XEoEX-?E|--M|X-To-o-X-?-EooB-E-oE?---o--?M-T-XBBE-----|-EX-o-T-?E-v
-oXo--|-oX-oTTX-X-Eo---TE------XXEX--E-X-o?ME|-TBE-B--MM----oX-|X-BBM-?-?---oB--M-?--X--TTXT-M--T--MMM--T---|-----o?--|---TMME---T-B-?--o-ME--o--T---M-|-B--XX|E-M--BEE--T-oXT-BBE-X-----TXB-E--X?----of
--TXo-X-TX-M--X--ET-T|---?o|------?T--MXXo--oX-E-BE-|?XX-------EBo-ME-o--|?E-E?-?--BXB--???---X---T-E--T-B-----E-E---M?-T-B-oooo-oMBo------?-|----B--?-T-X--|-M-?T--To--X-?-M-?---BE-|----------B-E----f
-o-|-MT?B-EXo?-E-|-?--T|BB--M-M|T--E-MB-|---ETM--X-o---?--X?B--|MT|ET-E-TX-T|M-Xo--X----|--?--ME-MET--Eo--|o?X------?|B-|-o---o?B-----BX--EXoE-Xo|-T-B----BoM--?|---M|--Eo--o--B-T---EE-||--|MT-?-X--M-f
---o-E-o---M-EB--|?--oM-oEM----o-|TE|?-X-TM----To--oE--oXB-TMX-T-----?TT-----T--o--------XX--BE-|-----o-E--T--?--E---T------?BT---X-----M--EE--XE-----|--o-----T|M---BE?EB---B-MMo--TM---E-XEE-T-B-B-E-f
-X----------E|?-|B---X|----E-?Xoo---?T?|o-?--M--T?-??MBMT--M--?--oE-oXB-?----oE-T-oXX--XT---?|-M|X--??B--|EE||-MM---|-MEBM---EBooM----BBM-oM----o-T-X|-|-?-T---M----o---BETE---?o-M--?|----|M----?----Mf
--o-?--X|B-|M--TTo---E-Bo--T--M--B-|E--?BoX|?To|-XMB-E--M-T--B-BE-----|ME|MM-|-XX----X--?M--|X?E|X--?-T-TBX---|----?-----T-E-T-o----B-?----?M--o-?MX-o-XoM------oX---?TMT-M-o-M----M---X------??--T-o--f
m--BBo?-T----o---o-XM-T----?--TT------|X--||---oM-B-E-|--X|----M-|---M------|---TMoEBB--X|E--?T-o---??X--TX-E----Bo--|-|Bo-M|--T-B-|----T---XM-o-o|-----|ToMB-|XBBM-?|-o-|-?-----T-Bo?M-|-o-------?--BoX
XXXXXXXXXXXXXXXXXXXXXXXXXXXXXXXXXXXXXXXXXXXXXXXXXXXXXXXXXXXXXXXXXXXXXXXXTXXXXXXXXXXXXXXXXXXXXXXXXXXXXXXXXXXXXXBXXXXXXXXXXXXXXXXXXXXXXXXXXXXXXXXXXXXXXXX-XXXXXXXXXXXXXXBXXXXXXXXXXXXXXXXXXXXXXXXXXXXXXXXX
