----------------------------------------------------------------------------------------E------------------------------------------------B-----|--------------------------------------------------------
----------------------------------------?-------------------X-----------------------------B-----X---------------------------|---------------------------------------|-----------------------------------
--------------------T----------------------------------M-----------?----------------------------------------------------------------------------------------T-----|-------------------------------------
----------------------------------------|-------------------------X-------------------------o-------------------------?-----------------------------------------------------------o---------------------
-o---------------------------------------------------------------|---------------------------------------------B----------------------------------------------------------------------------------------
------------------------------E----------------E----------------------B----------------|------------|-----------------------------------|---------o-----------------------------------------------------
--------------------------?-----?----------------------------------------------T-----------------------------------------------X------------------------------------------------------------------------
---------------------------------------------------|-------------------------X----------------------E----------B-------T-----------------------------------------------------------------------?-------v
-------------------------------------------------------------------------------------------------------------------------------------------o---------------------------------------------------------B-f
--------------B-------|--------|-------------------------------------------------------------------B-----------------------------T-----------------------------------------------------o---------------f
---------?------------------------------------------------------------------------------------------------------------o------------------------------------------------------B----X--------------------f
--------------------------B-----------X----o----------------------------------o--X-------------------------------B------------------------------o------------------M-----------|-----------------------f
----------X------------------E-------?-----------X--------------------------X----------------------------------------------------------------------|----------------------------------E------o---------f
----------------------------------------------------------------------------------|--------------------------------------------------------------------------------------------------------------------f
m---T--X--------------------------------------------------------E--------------------------------------------------------------------------------------------------------------------------------------X
XXXXXXXXXXXXXXXXXXEXXTXXXXXXXXXXXXXXXXXXXXXXXXXXXXXXXXXXXXXXXXXXXXXXXXXXXXXXXXXXXXXXXXXXXXXXXXXXXXXXXXXXXX?XXXXXXXXXXXXXXXXXXXXXoXXXXXXXXXXXXXXXXXXXXXXXXXXXXXXXXXXXXXXXXXXXXXXBXXXXXXXXXXXXXXXXXXXXXXXX
