-----------------------------------------------------------------------------------------------------B------------------------------------------?-------------------------------------------------------
------------------------------------------------------------------------------------------------------------------------------------------------|---X---------------------------------------------------
--------------------------------------------------------------------------------------?-----------------------------------------------------------------------------------------------------------------
----------------------------------------------?---------------------------------------------------------------------------------------------------------------------------------------------------------
-------------------------------------------------X?--------------B---------o---------------o--------B---------------------------------------------------------------------------------------------------
--------------------------------------------B----------------------------------------------------------------------------------------------------------------------o------------------------------------
-----------------------------------------------------------------------------o-----------------------------------------------------|---------------------------M----------------------------------------
------------------------------------------------------------------------T-----------------------------------------------T---------------------------------------------X-------B----------------------o-v
--------------------------|------T---------------M-B---T------------------------o-----------------------X------------------------------------------------------B---|o----------------------------------f
--------------------------------------------------------------------B---------------------------------------------?------------------------------------------------------------------------------------f
-----------------------------B--------------|----------------------------------------------------------------------------------------?-----------------------------------------------------------------f
--------?----o-----------------------------------------------------X---------------------------------------|-----------------------------------------------?--------------------X----------------------f
--------------|-----------------------------------------------------------------------------------------------------------------------------------?----E-----------------------------------------------f
---------------------------------------------B---------------------------T------------------B----------------------------------------------------------------------------------------------------------f
m----------------------M-------------------------------------------------------------------------------------------------------------------------------------------------------------------------------X
XXXXXXXXTX-XXXXXXXXXXXXXXXXXXXXXXXXXXXXXXXXXXXXXXXXXXXXXXXXXXXXXXXXXXXXXXXXXXXXXXXXXXXXXXXXXXXXXXXXXXXX-XXXXXTXXXXXXXX?XXXXXXXXXXXXXXXXXXXXoXXXXXXXXXXXXXXXXXXXXXXXXXXXXXXXXXXXXXXXXXXXXXXXXXXXXXXXXXXXX
