--------------------------------------------------------------------------------------------------------------------------------------------------------------------------------------------------------
--------------------------------------------------------------------------------------------------------------------------------------------------------------------------------------------------------
--------------------------------------------------------------------------------------------------------------------------------------------------------------------------------------------------------
----------------------------------------------------------------------------------------------X---------------------------------------------------------------------------------------------------------
--------------------------------------------------------------------------------------------------------------------------------------------------------------------------------------------------------
-----------------------------------------------------------------------------------------------------------------------------------------------------------X--------------------------------------------
----------------XXX--------------------------------------------?------------------------------------------------------------------------------------------XX--------------------------------------------
------------------------?--------------------------------------------M-----------------------------------T---------------------------------------------?-XXX-------------------------------------------v
-------------------------------------------------------------------------------------------------o-------|----------------------------------------------XXXX-------------------------------------------f
--------------------------------------------------------------------------------X------------------------|---------------X-----------------------------XXXXX-------------------------------------------f
-----------------------------------B---------------?----------------------------------------------T----XX|XXXXX---------XX----------------------------XXXXXX-------------------------------------------f
------------------------????????--------------------------------------------T---------------------|------|-------------XXX---------------------------XXXXXXX------------------------------X------------f
----------------------------------------------------------------------------|-------X-------------|------|------------XXXX--------------------------XXXXXXXX-?----?------------------------------------f
-----------------------------o----------------------------------------------|-------XX------------|------|-----------XXXXX-------------------------XXXXXXXXX------T------------------T-----------------f
m---------------------------------------------------------------------------|-------XXX------X----|------|-E--------XXXXXX------------------------XXXXXXXXXX------|------------------|-----------------X
XXXXXXXXXX--------XXXXXXXXXXXXXXXXXXXXXXXXXXXXXXXXXXXXXXXXXXXXXXXXXXXXXXXXXX|XXXXXXXXXXXXXXXXXXXXX|XXXXXX|XXXXXXXXXXXXXXXXXXXXXXXXXXXXXXXXXXXXXXXXXXXXXXXXXX-----X|XXXXXXXXXXXXXXXXXX|----XXXXXXXXXXXXXX
