--------------------------------------------------------------------------------------------------------------------------------------------------------------------------------------------------------
--------------------------------------------------------------------------------------------------------------------------------------------------------------------------------------------------------
------------------------------------------------------------------------------------------------------------------------------------------------------o-------------------------------------------------
--------------------------------------------------------------------------------------------------------------------------------------------------------------------------------------------------------
----------------------------------------------------------------------------BBB-------------------------------------------------------------------------------------------------------------------------
-----------------------------------------------------------------------o----------------------------------X---------------------------------------------------------------------------------------------
---------------------------------------------------------------------------------------------------------XX??????-------o-------------------------------------------------------------------------------
--------------------------------------------------------------------------------------?-----------------XXX-----------------------------------------------------------------------B--------------------v
--------------------------------X----------------------------------------------X-----------------------XXXX--------------------------------BBBBB-------------------------------------------------------f
------------------------------------------------------------------------------XX----------------------XXXXX--------------------------------------------------------------------------------------------f
--B--------------------------------------------------------------------------XXX---------------------XXXXXX-------------------------------------------------------------------------B----------o-------f
---X--------------------------------------------X---------------------------XXXX--------------------XXXXXXX-------------------------T------------------------------------------------------------------f
---------------------------------------------------------------------------XXXXX-------------------XXXXXXXX-------------------------|------------------------------------------------------------------f
----------?--------------------------------------M------------------------XXXXXX------------------XXXXXXXXX-------------T-----------|----------------------------------------------?------------------Tf
m--------------------------------E---------------------------------X-----XXXXXXX-----------------XXXXXXXXXX-E-E---------|---------E-|---------------------------------X-------------------------------|X
XXXXXXXXXXXXX-------XXXXXXXXXXXXXXXXXXXXXXXXXXXXX-----XXXXXXXXXXXXXXXXXXXXXXXXXXXXXXXXXXXXXXX---XXXXXXXXXXXXXXXXXXXXXXXX|XXXXXXXXXXX|XXXXXXXXXXXXXXXXXXXXXXXXXXXXXXXXXXXXXXXXXXXXXXXoXX--XXXXXXXXXX---|X
