-------------------------------------------------o---------------------------M------------------------------------------------------------------|-------------------------------M-----------------------
------------------------------------------M-----------------------------M------------------------------------M------------E-----------------X--------------------------T--------------------------------
------------------------------------------------------E--------------------------------------------------------------------------------------------------E-----------T----------------------------------
----------------------------------------------------------o----M---------X------------------------------------------------------------------------------------------------------------------------------
--------|-------------------------------------------------------------------------T--------------------------------X------------T-------------------------------------o---------------------------------
-----o----------------------------------------------------------------------------------------------------------------T-------------------------------B------------------------?------------------------
-M--------------------------------------------------------------------------------------X----------------------------------------------B-----------------------------------------M-----------X----------
------------------------E---------------------------------------------T-------------T------------------------------------------------------------------------------------------------------------------v
---------T------------------------------------------------------------------------------------------------------------------------X---------------------------------------T-----------o----------------f
----------------------------E-----------------------------------------------B-----------------------------M--------------------------T-------------------T---------------------------------------------f
-----------------------------------------------------------------------------------------------------------------------------------------------M-----------------------------B-------------------------f
---------------------------------------------E-|-----------------------------------T------------------------------B--------------------------------|--------------------------------------------TM-----f
-------------------------------------------------------------------------------------B-----------------------------------------------------------------------------------B--B--------------------------f
------------------------------------------------------------------------------------------------------------------------------------------X------------------------------------------------------------f
m----------------------------------------------------------------------------------------------------------------------------------------------X-------------------------------------------------------X
XXXXXXXXX?MXXXXXXXXXXXXXXXXXXXXXXXXXXXXXXXXXXXXXXXXXXXXXXXXXXXXXXXXXXXXXXXXXXXXXXXXXXXXXXXXXXXXXXXXXXXXXXXXXXXXXXXXXXXXXXXXXXXXXEXXXXXXXXXXXXXXXXXXXXXXXXXXXXXXXXXXXXXXXXXXXXXXXXXXXXXXXXXXXXXXXXXXXXXXX
