-B-------?B-MB---------------BE-------------|------------B--X---o-X----M--TE--M-----o-----EBo?---B----M------|----E-----M---M--E--------------M-----X----X---?X------X----|-E------B--------------------
-----T----E?--o--MB----o--o--TM--------T--?--oB--E-XB--oE----BX-----E--TB------------------M-EB-B--?o------------|---X-X---|--------E--B--T?--B--------M-MMoo-o-------------------------T---M--?-o------
-E--EBo----M-------------T---o---|------------TB------T--XE-----M--EMB-BB--o---------B-E--------E----|T----?--|-----o---M-----?----------E--?------X----E--M---------------o----B-T--X--E-------X-oB----
-B-----B-T-------oX----E-----|-----?X--?-|------T------EE------------o|E|-----|---------B----?-BX-?o---o-M-----E|----T----|B----T-X--M--oo--EoXM-X---E--|-------------------E-----X---B---|-----oo----M-
-----B----T-TE--T-|o--?------------oB-------------T----M--o-?-B-|------o|--M-o---B-o---T------o-----B--EB|----Eo-X--------T---------o-T--XMT----E---?--------|-----T-M--o----Xo---B--M--B----M----------
-E------------M--|----?-M----X-MX---------|-----E--------B--XM-----------E---T---X----M---B-----------o----|-EBX-------EET------B-|--Xo---X-MM-E--?-------|---------T---|---E--B-M-E---?---X-----T-B----
--?----B-----E---------------BoX-|M---------------|-oB-------?-B------E---X-M-------?----?----------?--?--|------?-T---T-------M---TE---E--M--M---|-X--E-M---?-----o--M-E--o-------|T----B-E-o-?-|------
--------?-EE-----o---M-------o--E|--------------X----|T-------X----E-----?-M----o--X--------Xo----|----------|-o?----X-X------o--T---Mo----M-o-oT?-----------|------M---E--T--|-B--------------MB-X-|--v
---E---------?---?--M---B--B----?|----E-------M-M--T---o--B---T--o--|-X--EM-T--------B---X-E--E?|---X--T-|-----TT-----X----?--E----E|E------XoB-X---------------X-M-T---B-?T----|--M?--------o-T----T--f
-----E--B---------T-|M----EB----?--------?--------B---B---|Xo----B----o-To-------o-----?-------B--------XT-X-M|---------X-----?--o?----B-B-o------T-----|--B---M---------BX----B-----E|-----MM--E--T---f
---E---E?---XT-|X--?-T-o-X--E-----T--|---------?------|T----M------X|-X-M--T|-|T-|---|-X----|TXX---M|----?--X----BT--?|--------------?-|---B-T--?X--?X-----------BX--|-----BM-----|E|--T-----T---M-B--Tf
----T-|--|---------E-------T---T------B------E-----------T|-B---o--------------M-?-----------o?--------?------B--o-----?---o---E?-?oE----|--------E-----B-|-BM-BXTT-M---X-M----?-|E|-------T----B-----?f
---|-E-B-|---X------T--M-----E----X--B|-----------B---o-TM---------E-----M-Mo|---------------?B-------------T-----o--E----B--|M-------B--o-------X-?--T-?--------o------------X-?-oTT---|--T-?-X----o-|f
-----E------|--|-----E-T--B---B--E--------o?---------M----X----|-X-----------o-----|------MXM-----EB----M--M---------M---|--M-----|--o----T----M------|--EE-?------|-B-----M-B-EoB-----------M?--?---?-f
m----?----o----TT-------?-------------|-B-o-|-------X--o-------------|--------T--X---o--?-T-X-----B-B--BT--X---o----o------X-----?--T-----M--Bo--E---M-E-|-|o---------M----|----|B--------E-?-X--|X----X
XXXXXXXXXXXXXXXXXXXXXXXXXXXXXXEXXXXXXXXXXXXXXXXXTXXXXXXXXXXXXXXXXXXXXXXXoXXXXXXXXXXXXXXX?XXXXXXXXXBXXXXXXXXXXXXXXXXXXXXXXXXXXXXXXXXXXXXXXXXXXXXXXXXXXXXMXXXXXXXXXXXXXXXXXXXXXXXXXXXXXXXXXXXXXXXXXXXXXXXX
