----|-----------------------o----------------E-------oo----------M-----E-----------B--?-----------B--B--o--------?----------E-----M-------X-?-----------X------------B-----?---BB-----E-----------------
--------------------------------E---M-----?-----E----------T---B----------------E---------------------XX---------??---E--------------------------M-?---X-M---------------------------B----------E---E---
---------E-----------o---X------------------?---B----------M--B----B------B---X---M-----M-E-----M--------XM---E--E--------o--------------Eo---M--------?--------------------------------------E-----M---
---M--B----X--X-----E---E---------M-M----------------B-----?---X?-------?o---------------T-------E----------------------------X-----o--------X-----T--X----?-------------E--------------?-------?E------
---TT----E-----B---------?-M-----------X-------------?-----------X----M?---------M-------X-----------E--------------E--BB--B-----o---?B-?------M--------o-----o-----------------M-o----B---X-----M-B----
---M----------------?-------X-----------?----------------B-----------?------B---o--o------X-----------------------X------B-E----------------?--------o------------------------X----o--------------------
---o-------M-----------E--Mo---------o----------------o-----Xo----oM--M---E--X---M-?B--?------------------M-----?------o--------------------------M--?--------X-M-X-M------X-----------T---B------------
-?-----------------X-----------------T---B-------------o-------E-M----M------------------------------X---?-X---B---M------------------E-----B----?-----------?----o---M--?-------------X??----B--------v
--X-M---------M-M---------o-------M--?M-BX---E---T-M---o------------o----B--X-----M-------------B--M----?--X--------------M---------------?---o---MX-----------------M---E-M---EM------B-EM------------f
-------X--------M-----MB?---------E-----E----B--BM----------------------?---------B----E----------------------------M------B--------------E----E-o----XE---------X--o-----B----------E--EM-----X-------f
---E----E-o---------E------------ME-B--B---------?----MB---EX--X--------------o-----X--------------BE------oo-E-------M-------?----B-----------------------------M---o--------E---------o-----E--X--E--f
------------?--X-----?----------------B-----------o--------------------T--------X----------o--?E--------M?------?------oM------M------X--E---Bo---------T--------E-----------X-----------X-------------f
-----------------------E------------M----------X--?--------------------B-----------------------o-----------------------?-----------------------M--------|--B?E--oX---------------X-----------X---TE----f
------E---o--X----M-------------o--------------B-------------------T-------------------------------------X-B-----o-----?----------B------E--X----B------X----------B---------o----?-------o------?-----f
m-T--------------------T------T-----E------E--------------M--T-T-T-X------------TT--E-----------------------B-------------------?----------o--?-------o------?--?---E-----------------MB---------T-----X
XXXXXXXXXXXXXXXXXXXXXXXXXXXXXXXXXXXXXXXXXXXXXXXXXXXXXXXXXXXXXXXXXXXXXXXXXXXXXXXXXXXXXXXXXXXXXXXXXXXXXXXXXXXXXXXXXXXXXXXXXXX-XXXXXXXXXXXXXXXXXXXXXXXXXXXXXXXXXXX-XXXXXXXXXXXXXXXXXXXXXXXXXXXXXXXXXXXXXXXX
