-MBMBoB|?|T?oXEEM??B??ETo?-XEXTMBMoX-?MTM??E?|?oE|-MXoE---?|BTBoXX|XBE|M??|o-|--ToET-|MM-EMXM-Xo|--TEoXXEXBXBX?T-|MX?T?-EBT|-|T-?B|-|XXEoM-XoEE?oE?-BM-o|X?M?M-XB-EMX?|X?E-T?-MMTBX?-E|BBTB?|-BX-oB-EBoM
ooM-E|B|B|||EXB|E|E|MEB||||||B|B|BE-?B||ET|o||T|?|-?TX-|-B||o|BE|-|T|?|EM||B||X|||-|M|B?|B|E|oEE|X?|-M|?EEE||EE|||XE||XBoE||-||BM-|-|oX|?E?BB||-E|M?Bo?X||ETM|?T?ToB-M|E-B|||||B|||T|||MT|TE||--?T?-?|BB
?E||||M|||||-TX|M|X|T||||||||||M||||||||M||||||||||||BE||?||B|B?|||||-||||||||?||||||||T|||o|||-|E-||?|?|||||?||||M||||M|T||M||EEE|||-|||X|X||||M|BX|X-M||||o||||||B|||X|B|||||||||||||-|||?||||||B||||B
E|||||?|||||B||||||||||||||||||o||||||||||||||||||||||B||o||||XT||||||||||||||X|||||||||||||||||||X|||||||||||||||||||||||||||||--|||T||||||||||||Eo|T|||||||||||||E||||||||||||||||||||||||||||||E||||?
X|||||||||||M||||||||||||||||||-|||||||||||||||||||||||||T||||||||||||||||||||||||||||||||||||||||M||||||||||||||||||||||||||||||-|||||||||||||||||||||||||||||||||X|||||||||||||||||||||||||||||||||||B
o|||||||||||B||||||||||||||||||||||||||||||||||||||||||||||||||||||||||||||||||||||||||||||||||||||||||||||||||||||||||||||||||||||||||||||||||||||||||||||||||||||E|||||||||||||||||||||||||||||||||||X
X||||||||||||||||||||||||||||||||||||||||||||||||||||||||||||||||||||||||||||||||||||||||||||||||||||||||||||||||||||||||||||||||||||||||||||||||||||||||||||||||||||||||||||||||||||||||||||||||||||||E
B||||||||||||||||||||||||||||||||||||||||||||||||||||||||||||||||||||||||||||||||||||||||||||||||||||||||||||||||||||||||||||||||||||||||||||||||||||||||||||||||||||||||||||||||||||||||||||||||||||||v
E||||||||||||||||||||||||||||||||||||||||||||||||||||||||||||||||||||||||||||||||||||||||||||||||||||||||||||||||||||||||||||||||||||||||||||||||||||||||||||||||||||||||||||||||||||||||||||||||||||||T
T||||||||||||||||||||||||||||||||||||||||||||||||||||||||||||||||||||||||||||||||||||||||||||||||||||||||||||||||||||||||||||||||||||||||||||||||||||||||||||||||||||||||||||||||||||||||||||||||||||||X
?||||||||||||||||||||||||||||||||||||||||||||||||||||||||||||||||||||||||||||||||||||||||||||||||||||||||||||||||||||||||||||||||||||||||||||||||||||||||||||||||||||||||||||||||||||||||||||||||||||||E
B||||||||||||||||||||||||||||||||||||||||||||||||||||||||||||||||||||||||||||||||||||||||||||||||||||||||||||||||||||||||||||||||||||||||||||||||||||||||||||||||||||||||||||||||||||||||||||||||||||||-
o||||||||||||||||||||||||||||||||||||||||||||||||||||||||||||||||||||||||||||||||||||||||||||||||||||||||||||||||||||||||||||||||||||||||||||||||||||||||||||||||||||||||||||||||||||||||||||||||||||||?
X||||||||||||||||||||||||||||||||||||||||||||||||||||||||||||||||||||||||||||||||||||||||||||||||||||||||||||||||||||||||||||||||||||||||||||||||||||||||||||||||||||||||||||||||||||||||||||||||||||||?
m||||||||||||||||||||||||||||||||||||||||||||||||||||||||||||||||||||||||||||||||||||||||||||||||||||||||||||||||||||||||||||||||||||||||||||||||||||||||||||||||||||||||||||||||||||||||||||||||||||||M
XXXXXXXXXXXXXXXXXXXXXXXXXXXXXXXXXXXXXXXXXXXXXXXXXXXXXXXXXXXXXXXXXXXXXXXXXXXXXXXXXXXXXXXXXXXXXXXXXXXXXXXXXXXXXXXXXXXX-XXXXXXXXXXXXXXXXXXXXXXXXXXXXXXXXXXXXXXXXXXXXXXXXXXXXXXXXXXXXXXX-XXXXXXXXXXXXXXXXXXX
