-B---X---?B-?--T--------T---MBE----o---T--o---------E----B--X---o-X---T---TE-E------o------B-?----XM--M-T------o--------M----M----------------M----------X--o----B---X--o----------B---------E------E-B-
----------E---o--MB-?--o--o----------?Eo--?--oB---?-----E-M--B?-o-------E-------------M----EXEB----?E------T-----|o--X-X-------X----E?-B-T-?E-o----B---M-MMo--o---E---B-?-o--oM---------|X------oo------
-E-------E|M-|-------?--ET---oE-T-|------T---?T----------X---X--M-|E-B-----o------M-------------------T---X?--|-----------B---?---o|B----E--?B---|------E--M?--X-------------E--B--------EM----o-B--To--
------XB--M-----?oX--|-E------E----?---?-|-B------E----EEX---o-------o|E|-------|---------o--M----?------------E|o-T-T-M-?------T----M--oo-BT--M-M--TE-----------------------E----X-|-o--o|-----|E------
-?B-T--?-BT--E--|----------------X--BX----------------EM------B-|--------E-M-o--BE|o-------------------EB|----Eo|X--|---------------o-T--XMT----E--|---T-----------T----o-M-BX----B------M-|-M--TB------
---------o----M--------------XBMX----X---M|?--E---|-----oB--X-X-----E----E--MT-----T?EM---------|E----T--E-|---X--?----E-----|T-B-|--Xo---X--M?E--?--E-E|-|------o------|---E--T--T----EX--X----E--Bo?--
----?--X-------|------T------Bo--|-----B----M---E---o--B---o---B-E-M-|E------EE--T-T?|---?o------------?--|---------E--B--o--X-----X----E-----M---|X--T----X-?---T----------?------------B-E-o-?-|------
---B---M?XE-----Mo-EMM-------o--E------XB-------X----X-BX-----Xo--T--B---?--------M-----B---X-o-----T-----To-|-o-T------B-----o-M-M-----X--M-X-o------E--B---|----B-M---E-----|?---------E--?--M--X---Mv
-B-ET-?|-|--?-o--?--M---------------------------M------o------T-----|BX--EM-T-----------------E?-E--X----------T-------?---?--B----E|E------|-----------M---o-----M-----B--T---E|--M?X-----oMo-T-------f
--|E-X?MB-----?o----BM----EB---E?--------?---X----oT------|-o----BM--?o--o------ToE----??---------?------T-X-M|-----?---------?-M--o-----BT-------T-------|---oM---------B----MB-----E|-----M----|-To--f
---E--ME-----T-|-|-----o-----o----T--|----T-M-------------?-M--XMoX?----M--T|-|TT---?-MXM---|TX----M-----?B-XXB--B---?--X----|-------?-|--XB-B---X--?T---o-------B---------B------|-|------------M-B-oTf
-?---------------T-E-----T------------B----?-E----B-?---MT--B---o-E----------E-M------------|-?--E---T-----X--B--o---BoM----------?-E-------------E-B-o---|-B-??X-----TB---?---?-|E|--M----T----B-B--M?f
-----E----T-?---o--X---M-------X--X--B---------?E?B-----T----------E--|--M--o----------------?B----?-TX-----T-----o-------B----?--T---B-------|--X-?----?--X-B---o------------XE---T--?-|------X----|-|f
---Eo-?--o--|---M----E-T-XB---B--E-------To--T-------M-------T----B---------?o-----|---?---ET-----------M-|---o------M---|--M-----|--o-------M-M--|---B-EEE------E------M|XM?--Eo|---M-------M----B--?-f
m----?M---o--B-TT--X-|-----------M----|-BBo-------o-X-?------o-E-?---|?------E-E-X------?X--X-----B----M-X-?-----------o-B-X-----?--T--X--M-|-o----------|?|-------M--M--B-|-T|-|--|T?----E-------BE---X
XXXXXXXXXXXXXXEXXXXXXXXXXXXXXXXXXXXXXXXXXXXXXXXXXXXXXXXXXXXXXXXXXXXXXXXXXXXXoXXBXXXXXXXXMXXXXXXXXXXXXXXXXoXXXXXXXXXXXXXXXXXXXXXXXXXXXXXXXXXXXXXXXXXXXMXXXXXXXXXXXXXXXXXXXXXXXXXXXXXXXXXXXXXXXXXXXXXXXXXX
