------------------------------------------------------------------------------------------------------------------------------------------------------M-------------------------------------------------
--------------------------------------------------------------------------------------------------------------o-----------------------------------------------------------------------------------------
------------------------------------------------------------------------------------------------------------------------------------------------------------------------------------------------B-------
--------------------------------------------------------------------------------------------------------------------------------------------------------------------------------------------------------
---------------------------------------------------------------------XXXXXXXX---------------------------------------------------------------------------------o-----------------------------------------
---------------------------------------------------------------------------------------XXXX-------------------------------------------------------------------------------------------------------------
---------------------------------------------------------------------------------------------------?----------------------------------------------------------------------------------------------------
----------------------------------------------------------------------------B-----------------?-------------------XX-------------------?????-------------------B---------------------------------------v
---------------------------------------------------------------------------------------------------------------M--------------------------o------------------------T-----------------------------------f
------------------------------------------X------------------------------------------------------------------------------X-----------------------------------------|-o?--------------------------------f
--T--------------------------------------XX----------------------------------------X-----?------------------------------XX----------M------------------------------|---------------o-------------------f
--|-------------------------------------XXX---------------------------------------XX-----------------------------------XXX-------------------X----------?????------|-----------------------------------f
--|------------------------------------XXXX--------------------------------------XXX------------------------------Mo--XXXX-----------------XXXXX-------------------|-----------------------------------f
--|-----------------------------------XXXXX-------------------------------------XXXX---------------------------------XXXXX-----------------------------------------|-----------------------------------f
m-|----------------------------------XXXXXX-------E----------------------------XXXXX----E-----------E---------------XXXXXX----------?------------------------------|-------E----M--------------E-------X
XX|XXXXXXXXXXXXXXXXXXXXXXXXXXXXXXXXXXXXXXXXXXXX------XXXXXXXXXXXXXXXXXXXXXXXXXXXXXXXXXXXXoXXXXXX------X-XXXXXXXXXXXXXXXXXX----XXXXXXXXXXXXXXXXX------XXXXXXXXXXXXXX|XXXXXXXXXXXXXXX--XXXXXXXXXXXXXXXXXXX
