-MBMB?B|?|TE-XEEM-?BBTEToo-?EXEMBXoX-MoMM?ToT|-XE-BMMoE-B-?|B-MoXX|BTB|M|?|oooX-T|ETT|M?BXMBo|MX|--EEoX-||BMBXo-||MX?TM--MT|o-TM?B-M--BXo??E-BT?o|??BETo|TM??T-oT-EMB?oE?E-X?XTMT|XB-EoBXTo?|EB?-oB-EToM
ooM-oMo|B||-M-B|--o|T|T|T|oM?Mo-|B|B?To|ET|-||T|?|o??X|||B||?|BE|o|-|?|?|M|B||oE||||||B?||XE||TM|X?o-MTT||T|MEEM||E||||BoE|||||X|-|TMBX|M-oBBB|-E|M?Bo|X|||TX|?o|?oBMX||?B|||T||||||ET?E?|TE|||-TTXE?|TB
?|||o|||B||X-|||X|o|||||||||||MM||||||B|||||||||T||TX?|||?||X||||o|X||||||||||?|||||||M-|||||||||E-M||||||||X?|X||M||||M?E|||||-|E|||-|||X|o||||M||Xo||T||||||||||XB||||?T||||||||||o|X-?||T|||-|||||||B
E|||||||?||--|||||||||||||||||M||||||||||||||||||||||||||E||||||||||||||||||||T||||||||||||||||||||T|||||||||||||||||||||||||||B|-|||-|||||M||||M||??||||||||||||||-||||||||||||||||?|E|M||||||||||||||?
X|||||||||||||||||||||||||||||T||||||||||||||||||||||||||||||||||||||||||||||||||||||||||||||||||||||||||||||||||||||||||||||||-|||||||||||T|||||||||||||||||||||||||||||||||||||||||||||||||||||||||||B
o||||||||||||||||||||||||||||||||||||||||||||||||||||||||||||||||||||||||||||||||||||||||||||||||||||||||||||||||||||||||||||||||||||||||||||||||||||||||||||||||||||||||||||||||||||||||||||||||||||||X
X||||||||||||||||||||||||||||||||||||||||||||||||||||||||||||||||||||||||||||||||||||||||||||||||||||||||||||||||||||||||||||||||||||||||||||||||||||||||||||||||||||||||||||||||||||||||||||||||||||||E
B||||||||||||||||||||||||||||||||||||||||||||||||||||||||||||||||||||||||||||||||||||||||||||||||||||||||||||||||||||||||||||||||||||||||||||||||||||||||||||||||||||||||||||||||||||||||||||||||||||||v
E||||||||||||||||||||||||||||||||||||||||||||||||||||||||||||||||||||||||||||||||||||||||||||||||||||||||||||||||||||||||||||||||||||||||||||||||||||||||||||||||||||||||||||||||||||||||||||||||||||||T
T||||||||||||||||||||||||||||||||||||||||||||||||||||||||||||||||||||||||||||||||||||||||||||||||||||||||||||||||||||||||||||||||||||||||||||||||||||||||||||||||||||||||||||||||||||||||||||||||||||||X
?||||||||||||||||||||||||||||||||||||||||||||||||||||||||||||||||||||||||||||||||||||||||||||||||||||||||||||||||||||||||||||||||||||||||||||||||||||||||||||||||||||||||||||||||||||||||||||||||||||||E
B||||||||||||||||||||||||||||||||||||||||||||||||||||||||||||||||||||||||||||||||||||||||||||||||||||||||||||||||||||||||||||||||||||||||||||||||||||||||||||||||||||||||||||||||||||||||||||||||||||||-
o||||||||||||||||||||||||||||||||||||||||||||||||||||||||||||||||||||||||||||||||||||||||||||||||||||||||||||||||||||||||||||||||||||||||||||||||||||||||||||||||||||||||||||||||||||||||||||||||||||||?
X||||||||||||||||||||||||||||||||||||||||||||||||||||||||||||||||||||||||||||||||||||||||||||||||||||||||||||||||||||||||||||||||||||||||||||||||||||||||||||||||||||||||||||||||||||||||||||||||||||||?
m||||||||||||||||||||||||||||||||||||||||||||||||||||||||||||||||||||||||||||||||||||||||||||||||||||||||||||||||||||||||||||||||||||||||||||||||||||||||||||||||||||||||||||||||||||||||||||||||||||||M
XXXXXXXXXXXXXXXXXXXXXXXXXXXXXXXXXXXXXXXXXXXXXXXXXXXXXXXXXXXXXXXXXXXXXXXXXXXXXXXXXXXXXXXXXXXXXXXXXXXXXXXXXXXXXXXXXXXXXXXXXXXXXXXXXXXXXXXXXXXXXXXXXXXXXXXXXXXXXXX-XXXXXXXXXXXXXXXXXXXXXXXXXXXXXXXXXXXXXXXX
