-----|--------------X------o-|M------?----------?--M-?----X-|E------M--------oB--o---|----M--E|--M------?---ET---M--oo-?----T---B-------o------X|------------E--X---B--T----MMEE----|-----o-B----T-T-MT-
--------------?-?T---XX-------X--MXoE----XoM---XBo------XTTT---E--|---X---T--T----?-----T---o--------o------------TX-----B-E-X---|----E-X---T-------X----------?E-M--?--EM------------B-o|X-----To-?----
-B-------o---X|--E--|TTE?--BT-E----o-M-B-----M--B----X?-X-----------M--------Eo---o----?-------------M---------BEE----------X---TB---B|B---|---|------M-------EX-?-|Mo---?-?|----EX|---X-o---o--X-------
-X------------E--o--E--Eo|---M--XX-B-----M?---------M--B--T------X--------?--E-E----X---T-E--B---B--o-?--o-|---B----M-o-EE---EXoE-------------------T---M----E-M--T-------TM---X--TX------METB----T--|--
---------TM---|E--M--ToM--XX-----------B-Bo-o-E-----M-T-|------XX----XX-EM-MB-oX-----------X-?---BB--?ET---BoE--------------o-----M--------------o----E-?-|--o-------MB-|-M?-|-----o------M-o------M--M-
--B---E?MX-o?--?---T?---B---------E?---------------X-B----M------||?-----B-X|-------------EB-------o--?To------T-B--X---X--X--MXEoX-M----o-M-------T-o--E?-o--?-T-X-----B----------------?-----B--------
--BoM---E|----oTM---B---?M--o-------------X---M----E-----?EE---T----------------B--BBB-E|--------------X-------?------M--B--------?--M-----|---M---X-X----EET-|--o-------------o----T-------M----XT--M--
-B----ME-EBTXoX----MT-----------X-|-----o----E--BE-------?-------EE---B---------T----X-?|T|o-----------|----o---?---M---|---M--------?-----E-------B--M-----oB-----X-?o----------------------o---------v
--M------E--T-------T|------M------T-M----?X---X---o-TM-E---E?-o--------M--------M----|--|----E----M--o-E|------------B-----EBX--o----B-|?---T-T--------|-M----B--M-------B-B-------|---|XB---E?------Tf
----o------T-Mo---o-E----M------o--M---B--EM-T--?---MX------o----------o-B----TX--------o|E-T-T---EM?-------|MMX---o-M---------o|-----B?----E-|-?E-B--o-------T---o----------E--?---E--o----BT---------f
-T-MX---MXX---?M-X-----oB--X?-M--|----T-|---oBM----X-------------------XEX-o--|X--B-B--?-o------BT-------M--T-X-------------?-ETT-M-|?----X|----------TM--B----M?T------XoEEX---M--o--?T----M----------f
---E?------X-?--------X-E----------B----Mo---|--|-M--B--o-o?---EB--------B---oB---oM-T--oo----B?-------X-----------XX-------To------|---oB----|---M----X-o--|E-oT-EE-M--B--?M--|----oT-?------T----E--Mf
------?------?-E-M-M----E----o-X---|T--EB----X-oo--M------?----|------B---------E---------T--M-----MoXM----M------o----M-|E-------M--?-----T--ET---MX-T----M--M-------?--X---B-------------o----B-|-X--f
--o--XB-T----M--------?----X-T--------|-B--M|?----E-E----B-E-o------?------E-----E-E-|T---|-----?T----------o---E--M---T---X--XB-------BM--E-B----------?--------TE--X---M----T-XTE-----B--E--?---M----f
m-M-M-----o--|----o-?-E-T--T----MX---MM-----------------B---XX---BTEM-M---?--B-----|?T-----M--B---E--E-M---?|BT--?---BM--MoT-X-----?-|o-oM-T---X---?--T-B-X--T-E-----M---|---|-M-T----TEEM----|--T----BX
XXXXXXXXXXXXXXXXXXXXXXXXXXXXXXXXXXXXXXXXXXXXXXXXXXXXXXXXXXXXXXXXXXXXXXXXXXXXXXXXXXXXXXXXXXXXXXXXXXXXXXXXXXXXXXXXXXXXXXXXXXXXXXXXXXXXXXXXXXXXXXXXXXXXXXXXXXXX-XXXXXXXXXXXXXXXXXXXXXXXXXXXMXXXXXXEXX-XXX-X
