-MXMB?B-Boo?oXEoM-?BBTXTo?-XEM?MBXoXo|o-M??BT|-BEoBMMoE|B-?|oTM-XMEXBB|MM?|oTXXBoEoT?-MBBMoXM-Bo|--EEBXEEEBXBXoB|-|||To--TT|T|-M?BMM?XXXoMXEoBT?o|?XBMBoB|?o?B-XB--oB?oE?E--?XMMM||?oEMBX-X?|oB?--o--TEM
oBMEXBo|MM||E-T|-|M|o|T|||oM|MX-|BE|?|||ETT|||T|?||?|X|||BE|o|BE-o|T|-|||o||||XE||||M|B?|B--|o|M|X?XoMMTEM-|M-E-||||||EB|||||||BM-|M|EX-TB?BB|||E|MXBo|EE|BEX|?o?EoMMX|E|B?|T|||||||B|?M-|BE|M|-TTXoE|TB
?|||--M|||||o|||E|X|T||||||||EMM||E|M|||M||||||||||?|?|||?||X|B?|o||||||||||||?||||||||T|||||||-|?B||?||-||||?|B|||||||B|||||||EE||X|BX||||-||||o|B||o|-|||||||o-||E|||X|T||||||||||o|X-B||?|||-|||o|||B
E|||||||||||B|||||-||||||||||?B||||||||||||||||||||||||||o||||X||B|||||||||||||||||||||||||||||-||E||?|||||||?|||||||||-|||||||B-||||T||||||||||M||||T|||||||||||||E||||||||||||||||?|EEo||E|||||||||||?
X|||||||||||M|||||-||||||||||||||||||||||||||||||||||||||||||||||?|||||||||||||||||||||||||||||?||M||||||||||||||||||||B|||||||oo|||||||||||||||||||||||||||||||||||||||||||||||||||||||T||||||||||||||B
o|||||||||||B|||||o|||||||||||||||||||||||||||||||||||||||||||||||||||||||||||||||||||||||||||||||B||||||||||||||||||||||||||||E-||||||||||||||||||||||||||||||||||||||||||||||||||||||||||||||||||||||X
X|||||||||||-||||||||||||||||||||||||||||||||||||||||||||||||||||||||||||||||||||||||||||||||||||||||||||||||||||||||||||||||||||||||||||||||||||||||||||||||||||||||||||||||||||||||||||||||||||||||||E
B||||||||||||||||||||||||||||||||||||||||||||||||||||||||||||||||||||||||||||||||||||||||||||||||||||||||||||||||||||||||||||||||||||||||||||||||||||||||||||||||||||||||||||||||||||||||||||||||||||||v
E||||||||||||||||||||||||||||||||||||||||||||||||||||||||||||||||||||||||||||||||||||||||||||||||||||||||||||||||||||||||||||||||||||||||||||||||||||||||||||||||||||||||||||||||||||||||||||||||||||||T
T||||||||||||||||||||||||||||||||||||||||||||||||||||||||||||||||||||||||||||||||||||||||||||||||||||||||||||||||||||||||||||||||||||||||||||||||||||||||||||||||||||||||||||||||||||||||||||||||||||||X
?||||||||||||||||||||||||||||||||||||||||||||||||||||||||||||||||||||||||||||||||||||||||||||||||||||||||||||||||||||||||||||||||||||||||||||||||||||||||||||||||||||||||||||||||||||||||||||||||||||||E
B||||||||||||||||||||||||||||||||||||||||||||||||||||||||||||||||||||||||||||||||||||||||||||||||||||||||||||||||||||||||||||||||||||||||||||||||||||||||||||||||||||||||||||||||||||||||||||||||||||||-
o||||||||||||||||||||||||||||||||||||||||||||||||||||||||||||||||||||||||||||||||||||||||||||||||||||||||||||||||||||||||||||||||||||||||||||||||||||||||||||||||||||||||||||||||||||||||||||||||||||||?
X||||||||||||||||||||||||||||||||||||||||||||||||||||||||||||||||||||||||||||||||||||||||||||||||||||||||||||||||||||||||||||||||||||||||||||||||||||||||||||||||||||||||||||||||||||||||||||||||||||||?
m||||||||||||||||||||||||||||||||||||||||||||||||||||||||||||||||||||||||||||||||||||||||||||||||||||||||||||||||||||||||||||||||||||||||||||||||||||||||||||||||||||||||||||||||||||||||||||||||||||||M
XXXXXXXXXXXXXXXXXXXXXXXXXXXXXXXXXXXXXXXXXXXXXXXXXXXXXXXXXXXXXXXXXXXXXXXXXXXXXXXXXXXXXXXXXXXXXXXXXXXXXXXXXXXXXXXXXXXX-XXXXXXXXXXXXXXXXXXXXXXXXXXXXXXXXXXXXXXXXXXXXXXXXXXXXXXXXXXXXXXXXXXXXXXXXXXXXXXXXXXX
