E--E|-E-X-T--M-----E----M---?--EoooX-o-BEE------T-----o--M-XT-------|--oo---E--M---MT|-o-|EX--MM?E-BXToT-M---o--XB-B-X-MME----XBB|?---X-X---X-----oM-----?BE--oE--o-T-T-B----|EMM-----BXX-o-o---X--B-XBE
--M-MMXMB|o---XBET-M--E-?----EBT?M-?o-E--oXE--|---X|---E-----E-METME---?-BBoX---T-EooToM---T--E---E--------oB|-?o|-XXMoT--BXEo-B---?M-------oX-?-?-M----?-T-o-B-o---B-o-BX-o-MT--M|--?Too?oo---o---?-|-E
|EXX|--EE|?|o---------M-E-o-E-T?-o-----E-|BM-----B-|?--Eo---E------?o-?--o----E-T-E---X----T?T-M?----MB--T-|TEEE--T--oTT-----B-T---|X----BM----E?-E-EE|-B--T-T---o-----X-?T-----T---TB-E--ME--TE-TE-MMT|
ET--o--TE---Mo-??-TX?-o---M--E-T--E-MBTT---E?-?---o----To--?BB|--T-B-?-X||BX|||-B-XoX?M-|E|---E--|-M-BBBEEB-----XMo|o|-X----oE-X------?-?EB-Xoo-X-ME--Mo---||---BTX--???---X?EM-|--X--oXTT-o|X-o----XBM?
T|B--X--------ETBX--?XM-oMM----T-M----B-Bo-ET--B-o---|?-Mo?--?----X-o?-E----T---oX----X---??-XM?---MM---?----o--M---E--EX-B-TMo|X--------TBB------E?-----oXBM-X--EMT--BE---X-MXM----TM-Xo||-?o-?-?-T---T
XBX----|-?-B--|--B-----??EEX-EEo?---B--E--o--?-E--E-M---TX-||E--?-?T--BM---TooE--EEo-BET?-ME-M-?--?----T||------X?-|-------M--M------M----X--?T-M---X------X-E|----?EXB|X|o-|--B----X-|T-----oE?-----o-B
?--BM|-M---o-B---?BB--B---??-X-oB---?--X-----XT--?T-B--X---o-M--E?M-?------?Xo----E--|----|-X-||-M-----T------T-BX--X-X-X||-o-------M--|?-T-?--T-----|--B--T---X?B--oM?--|-oX-o-XT-M----X|---|---|---X|o
?-E-T-?B------?M-XX----M-E-o||T?-B---E--?------EB---|M?-ET?-|-M|M-X-o--MET-B-X-------MMT----o--M-o-|-MM-X----M?--oTE-T--?--|?X----B-o?-----o--T--E-------?XB-o?--M---|M---|-|-X--BB--T------||E-E|---oEv
EX--B--MT-M-TX-M-Eo-o-E-?X-X-MB||B-E|-oEE-B--M-M-X-XEE-TM-E-oX|E-B-X-M?XT-T?E-BE----EB?X----E---|M-B----M--X?MB?B--?o-|E|----XT-----T---MX--M--|----?X-MoE-BXo-----XM|--X---E|----T--||XX--B--BBMMMo-BE-
?MB-B|B--o-T-?-o|??--X-|-ooXo---X-MXBT?-T-|-|-B-?M|T-----X-E-M--Mo-E--MBB-o?T--??-X-o---|?-X-MB|----o|--Eo--|--o?---Bo-B-?-T---M--B--TEB-?o-----M-X--|E-?-?X?B-TB--M|--X---X-oo-XX--TT--X--|-?X-oE-E-E-?
M--|--E-B--o------|E--?|--ooM|?-BB--T---M--E-Eo-XEB-|?-X---X--TM--?----T---|--MB|-M-|-MM-?--MMo-T|-o-X-E-B----|?-B-----EEo-T-M--B-M-o--X-??-Eo-o-EoE--M--oo-B--E-?-T---X?MB-MXB--EE--|T---|---X|-B-o--MM
----M----oE-|------MB-E--E-MoT??-B--M|---?-T?-E?M|M|oM--B----|-T-TX--E--B-XTX?o----T-E---oXo--M-T---T-XT-?----X--XMB----X-M-B----?--M---|-|-?-XB|T--B--X-|o--BB-oB-|--?-oB----X-E|X-E-MTX----o|X-T--|E-M
?---------T-T-?-EM-|---?|------|T-XEo-|-T-----MMT-B--E-oT-oT-E?|-X---B|--oMTT?-M-oX-?X----TX?---B--X-M---T-?---X|TT?---|?B?MT-T-B-o-oX--T|M---|--MBT|||o-|---?o---|--oB----B?X|-T-----?--EM-M--MB------X
oT--X--?--B-BEME----M-B--?---E|-E--EXT|Xo----------?-------|oXMM---|---?M--B-BE----T--B-----oBM--|B-B-X--EBE|XMX-E------T-o-B--ET-X-X--X-BXETE------M-T-EEBB-Xo-M--o-o?---E---EE--T??T---------------oo|
m-X-To|-EMB--?--M-?M--?-?M------X--B-B----Mo--|X-T-E--E--oX--T-X-T?E--T----T-M-E-M-X---------XB---oo-X--o?---B--M?--X--------X-MMX?XMBXB|?-?X---M?E-T-T--E-|--M--BXB-XE-o?E-M|?-?XX-o--XE---|-TT-B--X--X
XXXBXXXXXXXXXXXXXXXXXXXXXXXXXXXXXXXXXXXXXXXXXXXXXXXXXXXXXXXXXXXXXXXXXXXXXXXXXXXXXXXXXXXXXXXXXXXXXXXXXXXXXXXXXXXXXXXXXXXXXXXXXXXXXXXXXXXXXXXXXXXXXXXXXXXXXXXXXXXXXXXXXXXXXXXXXXXXXXXXXXXXXXXXXXXXXXXXXXXX
