---------X---------------------------------------o---------------------------M-------------------------------------------o------------------------------------------------------------------------------
-----------------------------|------------------------------------------M---------------------|---------------------------E---------M----------------------------------T--------------------------------
------------------------------------------------------E-------------------------------------------------------------------------------------------------------------------------------------------------
---------------B------------------------------------------o----M----?-----------------------------------------------------------------------------------------------------------------------------------
--------|----------------------------------------------------M------------------------------------------------------------------T-----------------------------------------------------------------------
-----o--------------------------------------------------------------T------------------------------------------------------------T--------------------B-------------------------------------------------
----------------------------------------------------------------------------------------------------------------------------------------------------E----------------------------------------X----------
----------------------------------------------------------------------T-------------T------------------------------------------------------------------------------------------------------------------v
-----------------------------------------------------------------------------------------|----------------------------------------X---------------------------------------------------o----------------f
--T---------T--T--------------------------------------------------------------------------------------------------------------------------B-------------------------------------------T----------------f
----------------------------M------------------------------------------------------------------------------------------------------------------M-----------------------------B-------------------------f
---------------------------??----------------T---------------------------------M----------------------------------------------------------------------------------------------------------------T------f
-------------------------------------------------------------------------------------B-------------------------------T----------------------------T----------------------B--B--------M-----------------f
-------------------------------------------------------------------------------------------------------E----------------------------------X------------------------------------------------------------f
m----------?-----------------------------------------E------------------------------------------T----------------------------------------------X-------------------------------------------------------X
XXXXXXXXXXXXXXXXXXXXXXXXXXXXXXXXXXXXXXXXXXXXXXXXXXXXXXXXXXXXXXXEXXXXXXXXXXXXXXXXXXXXXXXXXXXXXXXXXXXXXXXXXXXXX|XXXXXXXXXXXXXXXXXXXXXXXXXXXXXXXXXXXXXXXXXXXXXXXXXXXXXXXXXXXXXXXXXXXXXXXXXXXXXXXXXXXXXXXXXX
