----------------------------o-------o---?----E-------oo----------M-----E---??---------------------------o-------M?----------E--BM-M-------X-?B-----o---oX---?-------------M?-X--B-----o-E---------------
------------------------------------------?o----E-X--------T-----------------T------------------------XX--M------??-------------------M----------M---X-X-M-------?------------------------M-----E-------
----B----------------o---------?X-----------?---B----------?-B?------E-M--B--X----------M-E--------------X-T-----E-------M---B-----o-----E----M---E--E-?--------------------------------------E-----M---
---X-------X--X-----E---E---?-----M-------------------------------------?M-----------------------??--------M----?----------T--X---B-------T--X---M?--------E------------------E----?----?--------E------
-------B-E-----o---------?-M---------------M---------?---?-------X--B--?-----o---M------o?----------MoM-M--------------B---B----------B---M----M---?----------------------------M------B-------T-M-B----
-------E------------?------------------------------------B-------X----------B------o-------X-------M-------X--T---XE-------?----o-----------?---M--X-o---------------M--------X----o-------?---B--------
-------------------M---E---X---------o-----------o----o-----XoE---o?------------BM-?---?------------X-----M---?--B--------------X--------------BM-M--?------XE----X----X---------------T---B------------
-------------------X-----------------------------------------B--------------------------E---------M--X-?-?-------o-M-o----------------E-----------------o---------o---M--?-----M----?--X??----B-----o--v
----M-------X-------------?-------M-----BX---E---T-ME--o-------------B---B----B--------------M-------------X-------E------M---o--------B------o-E-M--------M---------M-----M-----------B-EB------------f
------E---------M------B----------E--T-E--------o?---X----M------------??---------------------------o---------------X---------------------Eo-----o----XE---------Xo-------B----?-------B-M-----X-M-----f
-?------E-o-E-------E--M---------ME-B?-B--------------MB-?-EXo-X------E-------o----------------o----E------o--EE-?--?-M-------?-------B--------------------------M--?-----B?------?-----oM-------X--E--f
------------?--------------E-------------------o-Xo----?--------------oT------B-X----------o---------------------------o-------M--E---X--X---B-------------E-----E-----------X-----------X-------------f
-----------------------E------------M----------X-----------------------M-B-----------?--?o---?---------------B---------?-------------------------------B---B?-T--X------------E------E-------X---TE?---f
------E---o----?---E-M---o------o-------------E-----E-------------------------------o----------------------B-----X----------------B------EB-X-----------X--M--X---?B---------o----?----T--o------?-----f
m-T--------------------T----T-T-----E---o-----------------M--------o------------T---------------------------B------------E---E--?----------oB-------------------M---E-----------------M|T-----M-TT-----X
XXXXXXXXXXXXXXXXXXXXXXXXXXXXXXXXXXXXXXXXXXXXXXXXXXXXXXXXXXXXXXXXXXXXXXXXXXXXXXXXXXXXXXXXXXXXXXXXXXXXXXXXXXXXXXXXXXXXXXXXXXX-XXXXXXXXXXXXXXXXXXXXXXXXXXXXXXXXXXX-XXXXXXXXXXXXXXXX-XXXXXXXXXXXXXXXXXXXXXXX
