-o----T?E-T--M--------o-----?--X---Eo--o-----------o---E---M---M-----?-B------B----------?-----------------??-?-------------------E---?-------------M--B---ME---------------------X-------M--o----------
----o-M-o-|--------------o---BB---------?--X---X-----B---------M---------o---------------?X------M-----------?--------------T----M------E--------------------------X---?--o-BX-o------M--M----o--B----o-
--E-------M----?-B--o------T?-E-oo--X-B-------B--M-X-------o-------B------------------o----------------------------X-T------X-----o--M---X--?---?-------------M------------B-------------X-------B--o---
-------T---------X---------?--X-----o---T-----M--?-E-M------------?------?-E-M-------------------T---MX--------------M---------?-------------BM------M----------E---------T-----------M--T--?---?E------
---?-oX?-------M-----??-------E-----XM--X--B---?-B----------?-----?------------o--------B---Bo---M-----M---------B--XB---B-?-------?-------T?-E-X------B------M--MX--?----B---?-----o----B--------------
--------M---B--o----X-E----------------X-----------M--E-------M----MB-M---?--M-X---------------BoE---?--oT-------------o-----?----M----?---X------T------E---EB-----To-----M------------------------?---
----X---?--------o--------------------------E---------------B-----E-------B----X-----------o-E------X----X-------T------------o---B-------------E-M----E--------M---BX--o-----E-------o-X-----X-------T-
---MoX--E------E---B-------E--T-------B---------------------X----------?-----------------M--E---X--------oM------X---M--------X-----------B-----------------------------------?M----B----M-----BM-----?v
-----M------------------------B-?---------?-----X---o-----------?-----ET-EB--------o---------XEX------B-----M?-----?o-B--------------?--X-----E-----------B-M--E-------BE---------?-o-----M----TX-X----f
-E----T----------o-E------------T---------------M-M-EE-------------X---ME---oE-o-M----?------o------------------------------------B------?----E-E--X---B----------o--?M---X----B-?----o-----?--M---?--of
---E--X------X----?--o-T-T-?----?----------------?-------E--------E----------o-X-------X--M-o-T-------X--?-------------------E-------B----B------------------T------X----------------B-----------B-----f
--------T------E--MB--EX-B---------------------?--------------?-------o?-----B--B--X--B-?-----?----X-?----M-------?----------o---------------E---------X-----X--E-------------TMM--o-E-B----BME--XE---Ef
-----B-TB---?----------------------X-----M---------oM------------X----------E--------E--T---------------E-------MB-----------------M-X-------To---------------o--o-?--o-------X---?o----------------M--f
-----E-X---------------EM--B------B---MM-B-B-------------?X?-----X---X-------------?----X-B---B-X-----------T---E--X---?-B--T-----X----------B---X---------------M----?--?------------X----------------f
m-T--T-?---M--M-B--------E----EX--X--------M--M--T--T------MB---?------X-Mo------------T----T-B---o-TT---M--|------------M-BB-----M---X------------TEB---?-------------------T----E------B?--B--TB---X-X
XXXXXXXXXXXXXXXXXXXXXXXXXXXXXXXXXXXXXXXXXXXXXXXXXXXXXXXXXXXXXXXXXXXXXXXXXXXXXXXXXXXXXXXXXXXXXXXXXXXXXXXXXXXXXXXXXXXXXXXXXXXXXXXXXXXXXXXXXXXXXXXXXXXXXXXXXXXXXXXXXXXXXXXXXXXXXXXXXXXXXXXXXXXXXXXXXXXX-XXX
