----------------------------------------------------------------------------------------------------------------------Mo------------------------------------------------o-------------------------------
----X-o------------------------------------------------------------------------------------------------------------------B-------?----------------------------------------------------------------------
---------------------------------------------------------------------------------------------------------------------------------------------------------o-----------------------Xo---------------------
----------------------------------??------------------------------------------------------------------------B-------------------------------------------------------------------------------------------
-----------------------------------------------------------------X--------------X----------------------------X-----B------------------------------------------------------------M-----------------------
----------------------------------------------------------------XX-----------------------------------------X-----------------????----------------------------------------------------------T------------
---------------------------------------------------------------XXX-------------------XXXXXXX--------------XX-??----------------------------------------------------------------------------|--?---------
--------------------------------------------------------------XXXX-----X----------o----------------------XXX--------B----------------------------XXBBBBBX----------------------------------|-----------v
-------------------------------------------------------------XXXXX-------------------BBBBBBB------------XXXX------X--------------------------------------------------------o--------T------|-----------f
--------------------------------------------------------M---XXXXXX-------------------------------------XXXXX---------------B--------------------------------------------------------|------|-----------f
-------------------------------------------------------M---XXXXXXX--------------?-B--XXX--------------XXXXXX------------------------------------------------------------------------|------|-----------f
--------------------------------------------------------X-XXXXXXXX-----------------------------------XXXXXXX--------------------------------B---------------------------T-----------|------|---o-------f
--------------------------------X-----------------------XXXXXXXXXX-----------------B----------------XXXXXXXX----------------------------o-------------------------------|------T----|------|-----------f
--------------------------------M-----------------------XXXXXXXXXX------B---------B--o-------------XXXXXXXXX------------------------------------------------------------|------|----|------|-----------f
m-----------E------------------------------------E-----XXXXXXXXXXX-----------EE---------------E---XXXXXXXXXX--------------------------E---------------------------------|------|----|------|-----EE----X
XXXX--XXXXXXXXXXXXXXXXXXXXXXXXXXXXXXX---XXXXXXXXXXXXXXXXXXXXXXXXXXXXXXXXXXXXXXXXXXXXXoXXXX-------XXXXXXXXXXX--XXXXX------XXXXXXXXXXXXXXXXXXXXXXXXXXXXXXXXXXXXXXXXXXXXXXX|XXXXXX|XXXX|XXXX--|----XXXXXXXX
