------------------------------|----------------------------------------o-------------------------------------------E----------E--------------------------------------------------------------------|----
-----------E-----------B--------------------------------------------------------------------------------------------------------------------------------------?-----------------------------------------
-----------B-------------------------------------------B--------------------------------|------------------------------------------XE-----------------------T---------------------------------X---------
----------------------------------------|-------E--------------------------------------------------------M------------------M---------------------------------------------------------------------------
----------------------------------------------------------------------T-----E----------------------------------------------------------------------------------T----------------------M-----------------
--------------------------------------------------------------|--------------------o----------------T------------------?------------B-------------------------------------------------------------------
--------------------------------?----------------------------------------------T------------------------------------------------------------o---------------------o--------------------------|----------
------------------------------------------------------------------------------------------------------------------------|-----------------------------------------?------------------------------------v
--------|--------------------|---------------------------------------------------------------|---------X-----------------------------------------------------------------------------------------------f
-------------E-----------M-----|--------------------------------?-------------------------------------------------------------M------------------------------------------------------------------------f
------------------------------------------------------------------Bo-------------?---------------------------------------------------------------------------------------------------------------------f
-X------------------------------------------------------------------------X------------------------------------------M-B------------B-----------------------------------------------------T------------f
-------------------------------------------------------------------------------------------?-----------------------------------X-------------------|----------------------------------E----------------f
---------------------------------T------------------------------------------------------------------------------B--------------------------------------------------------------------------------------f
m--------------E----------------B--------------------------------------------------------------------M-----------------------------------------------------------------------------------------B-------X
XXXXXXXXXXXXXXXXXXXXXXXXXXXXXXXXXXXXXXXXXXXXXXXXXX|XXXXXXXXXXXXXXXXXXXXoXXXXXXXXXXXXMXXXXXXXXXXXXXXXXXXXXXXXXXXXXXXX|XXXXXXXXXXXoXXXXXXXXXXXXXXXXXXXXXXXXXXXXXXXXXXXXXXXXXXXXXXXXXXXXXXXXXXXXXXXXXXXXXXX
