-TTTTTTTToTTT-TETTTTTTTTTTTTTTTTTMTTTTTTTTTTTTTT-TTT-TTTTTTTTTTTTTTTTTTTTTTTTTTTTTTTTTTTTTTTTTTETTTTTTTTTT-TTTTTTTTTTTTTTT-TTTTTT-TTTTTTTTTTTBTT-TTTTTTTTTTTTTTTTTTTT-TTTTTTMTTTTTTTTTTTTTTTTTTTTMTTTTT-
-------ME?-??-E---oX---?-MB---X---o-?---?--BM---?--XM--BM--?X-?-BB--o--?B-?-ME-BEo--o--o-EM-o-----B----?M-XB---BEMM-M-B--?--o-EB--E?E-M--o--X-M-----B?-----o?BB-MBo-MM--BB-----oX-X-X----?X--XE---B-----
--M-X---o-B?-o-M-----EX---?-o-??-X-E-M?-oE-----o----XXBX------?---B-M---M-X--B-Mo-M-?-B--M--X-M-?B-?BM------E---B-XM?-?---oX--B---o---X--E--?-?----?-BM-XXEE---oM-M---X---o--???--X--X---o-----X-B------
--B-----?--MX-?---E--X-MoMME-MM?-X-X-M-XEE?B----M---EXo-?M-XM------E---o-B?--oo------B--?E-?X---EX--?---?---------E-?-?-M-----o-----X--X---X------M--o--E---o--X---oB-----X-B-o?---E?-o--------?XB--E?--
---X----X?B-X--oB----M--M--?M-o-X-?o------M-?E-B-X-M?--X-E--E-?-?XEX--MX---B-XM--XM-o-XXB-E--?E----BM---E?XBEE--X------oE--MX-?--E--?EoX--?X------X-EE?---X-oXX?----M--MEMBE--?E--B-E-o----B-X---XoX----
-o-Eo--o----?B-EB--X-M-B--B--XM?o-----?----B--?--E----?MXB-XB----M----?--B?-X--X--E--?---oM-?-X---EB--?-?-X-E-X--XXoMX---------E-?-X?X------EX-MEMooo-oB---MM--ME--EX----XXBB?--?-XE---M--B-?--E-ME?--X-
-X-M------o?-E---?oXEB--E?-X-M?-M?---X-?X---?X--BE--BEXE-M-XE?---E-Xo---X?---XE--o---B-MB---B---ooE----M--E-X--?M-----B-o---B?X---Xo-B-------BXXM--X---E--M--XBE--E--MM-XB--?X?--E-----XE---X--o-B----E-
-------XX-Eo-?X----X-MB?-B----M---XMX?-X---E-MEX-XX--B--M----X-----?--XM-X-B-?------?--o?---?XXEEM-M-?--XEMX-B---oo-M-XBEo--o--E-XM---??-o---M---?---X---X--oB---X?M------M-X?-M?E-XE-X--XXE-E--BE-----v
-XEM-X?Mo-E-XBo--X--B-Bo?o-X--XXBo----XB-??XBX--?B-----MX--?B?-BB?---------?X?XX----EB-B-----M-B--Eo-----o----M-EM-E?B-M-----E-E-MX-XX---X---o--X-X-X--X-XoXEXXMXXB-XX-B-M-X----X--M-??oBM--?X--oBM-XB-f
-E-?BoX?---X---XoE----MX---M-EXBX----B-----B--B-Xoo---o--XX-?--X---E-X--o------X--XBB-X??-?-X--XMX-o-o----Xo-?XoB---oXE----XM--X-X-oM------?E-X-M-o-o-EX----?B--BX-----MM------B?EX----B--M--XX---Xo?X-f
-E--XX|B--??oE--?B-E----E-??-B-E-o-o?-?MBXB----o----E--B-??---X--?MX-BE-?o-E-BM?Mo-o----oB--X-o--X-XE-??---E----X----E-----X-B-E-?-B----oX?--M---X---?XBX--------oo-E-----X?-XX-E--oB-B?XBoBM-M--BX-E-Bf
-XBo-X|EB----------BEX---X-MME-----X---X--o--o--MX---X-XM--XX---oX??--X--MXE------------?XB-o?B-o--EEEB-o-----??|Mo-EB?----?B-Bo---E--|--?X|M--XE-M-|XM--?X-E-X?-X--X--o-oX-M-------BB---X--Bo-X--?--X-f
-M--|-|--M-||-XB---E-|-X-Xo-|X-|X--?-E---XX|XX-BX|-X---oo--E---|o---X--M-?-||---o----||---|M|-|----o-B-?E-E----X|X---?-B--BEB--|-o--|-|X--||X--?---||XM|---|ME-M||-?EBB-MM|--M-oM--X----|-X|M-X------|-f
-|-||-|E|?-||-|XE-|-|||M-|XX||||-?-|-X|---|||-|-X|-|E||-|||X|--|M|-B|-|?||?|||X--|MX-|||--|B|||B|--|-|||-XM|X-o-||||--|XXoX|X||||B|-|X|-|-|||--o-|-|||X||--|M?|||||||-|||X|-X--|||-|-XX|||X|M---|M||-|-f
m||||||||-|||-|-|||||||||||||||||-||-||||B||||||-|||?|||||||||X|-||||||o|||||||||||||||||||||||-||||||||||X||M||||||||||o|-|B||||M|||||||||||-||X||||||||||||||||||||-|||||o-|||||||||-||||||||-|X||B||X
X||||||||X|||X|X|||||||||||||||||X||||||||||||||X|||X||||||||||||||||||||||||||||||||||||||||||X||||||||||X|||||||||||||||X||||||X|||||||||||X||X||||||||||||||||||||X||||||X||||||||||||||||||||X|||||X
