-MXMXMBTBTT?oXEEM|?BB?E?E?-|EXEMoMEX-ooTM??|TXXXE|BMEoETB--|X-BEXMXX?BBM??|oBXXBM|ET-XMoBXMXM-BE|-X?-BXBBX-X?Xo-M|M?oT|M-X||T|XMo||MXEXEoMXEoTE-o|?XBM-MB|?B??-TB--MX?EBBE-X?XTMToX|-EMBXTo?|oB|-oB-E-XM
oBT--|o|B||EM|B|-|ooT|||M|o|-Bo-||T-?T-|XT||||T|?|T-TXM||BE|-||E|o|-|M|?-M|||?|X||||||B?M||T|oTM|-Xo-MM?M|?||oEo||E|-||B|||||||TM||M|o--TBMB|||-E|M?|o|E||ETX|?|ETBBMX|EoB||B||-||M|B-?MT|TE|MT|TT?oE||B
?E||?|M||||?||||X|X|||||||||?|MM||||||T|M||||||||||||||||?||X||||o|E|-|||||||||||||||||||||||||||E||||||||T||?|B||M|T||M||||||||E|||||X|||X||||MM||||||T||||||||||XB|||EX|||X|||||-|o|X-|||?||||||B||||B
E|||o||||||||||||||||||||||||||X|||||||||||||||||||||||||E||B||||o|||||||||||||||||||||||||||||||T||||||||||||||||||||||||||||||||||||||||||||||||||||||||||||||||B|||||||||||||||?|?||E||||||||||E||||?
X|||||||||||||||||||||||||||||||||||||||||||||||||||||||||||||||||||||||||||||||||||||||||||||||||||||||||||||||||||||||||||||||||||||||||||||||||||||||||||||||||B|||||||||||||||B||||||||||||||||||||B
o||||||||||||||||||||||||||||||||||||||||||||||||||||||||||||||||||||||||||||||||||||||||||||||||||||||||||||||||||||||||||||||||||||||||||||||||||||||||||||||||||||||||||||||||||||||||||||||||||||||X
X||||||||||||||||||||||||||||||||||||||||||||||||||||||||||||||||||||||||||||||||||||||||||||||||||||||||||||||||||||||||||||||||||||||||||||||||||||||||||||||||||||||||||||||||||||||||||||||||||||||E
B||||||||||||||||||||||||||||||||||||||||||||||||||||||||||||||||||||||||||||||||||||||||||||||||||||||||||||||||||||||||||||||||||||||||||||||||||||||||||||||||||||||||||||||||||||||||||||||||||||||v
E||||||||||||||||||||||||||||||||||||||||||||||||||||||||||||||||||||||||||||||||||||||||||||||||||||||||||||||||||||||||||||||||||||||||||||||||||||||||||||||||||||||||||||||||||||||||||||||||||||||T
T||||||||||||||||||||||||||||||||||||||||||||||||||||||||||||||||||||||||||||||||||||||||||||||||||||||||||||||||||||||||||||||||||||||||||||||||||||||||||||||||||||||||||||||||||||||||||||||||||||||X
?||||||||||||||||||||||||||||||||||||||||||||||||||||||||||||||||||||||||||||||||||||||||||||||||||||||||||||||||||||||||||||||||||||||||||||||||||||||||||||||||||||||||||||||||||||||||||||||||||||||E
B||||||||||||||||||||||||||||||||||||||||||||||||||||||||||||||||||||||||||||||||||||||||||||||||||||||||||||||||||||||||||||||||||||||||||||||||||||||||||||||||||||||||||||||||||||||||||||||||||||||-
o||||||||||||||||||||||||||||||||||||||||||||||||||||||||||||||||||||||||||||||||||||||||||||||||||||||||||||||||||||||||||||||||||||||||||||||||||||||||||||||||||||||||||||||||||||||||||||||||||||||?
X||||||||||||||||||||||||||||||||||||||||||||||||||||||||||||||||||||||||||||||||||||||||||||||||||||||||||||||||||||||||||||||||||||||||||||||||||||||||||||||||||||||||||||||||||||||||||||||||||||||?
m||||||||||||||||||||||||||||||||||||||||||||||||||||||||||||||||||||||||||||||||||||||||||||||||||||||||||||||||||||||||||||||||||||||||||||||||||||||||||||||||||||||||||||||||||||||||||||||||||||||M
XXXXXXXXXXXXXXXXXXXXXXXXXXXXXXXXXXXXXXXXXXXXXXXXXXXXXXXXXXXXXXXXXXXXXXXXXXXXXXXXXXXXXXXXXXXXXXXXXXXXXXXXXXXXXXXXXXXX-XXXXXXXXXXXXXXXXXXXXXXXXXXXXXXXXXXXXXXXXXXXXXXXXXXX-XXXXXXXXXXXXXXXXXXXXXXXXXXXXXXX
