-----------------------------------------------------------------------------------------------------------------------T--------------------------------------??----------------------------------------
-M------------------------------------------------------------------------------------------------------T-----------------------T-----------------------------------------------------------------------
--------------------------------------------------M--------------------------------B--------------------------------------------------------------------------------------------------------------------
---------B----------------------------------------------------------------------------------------o-------------------------------------------T---------------------------------------------------T-----
-------------------------------------------------T--------------------------------------------X---------------------------------------------------------------------------------------------------------
---------------------------------------M-------------------------------T------------?----------------------X--------------------------------------------------------------------------E-----------------
-------------------------------------------------------------------|--------------------------------------B-|-------------------------------------------------------------------------------------------
----------------------------------------------------B------------------------------------------|-------------------------------------------M---------------B--------------------------------?----------v
--------------------------------B--------------------T------------------------------------------------|------------------B------------------------------B----------------------------------------------f
-------------------------------------------------------------E--------B-----------------?-----E--------------------------------------------------------------------------------------------------------f
-----T-----------------------------------------------------------------------------------------|------------?------------------|-------------------------------------------o----------T----------------f
------------------|-----------------------------?B------------------------|B----------------------------------------------------------------------|-------------------------------------------------M--f
-----------------o----------------------X------------------------------------E-----------------------------------?---------------------------------o------------------------?------B-------------------f
--------------------?-----------------|------------------------------------------B--------------------------------------------?----------------------------------|-B-----------------------------------f
m-----------------------------------------------T-----------------------------------------------------------------------------------o----------T-------------------------------------------------------X
XXXXXXXXXXXXXXXXXXXXXXXXXXXXXXXXXXXXXXXXXXXXXXXXXXXXXXXXXXXXXXXXXXXXXXXXXXXXXXX-XXXXXXXXXXXXXXXXXXXXXXXXXXXXXXXXXXXXXXXXXXXXXXXXXXXXXXXXXXXXXXXXXXXXXXXXXXXXXXXXXXXXXXXXXXXXXXXXXXXXXXXXXXXXXXXXXXXXXXXX
