-----X-E?--E--------?-------o-XX??----------o---?-X---------X-----X---o----B---M---|--X---M---M--E---?---M--XME-?--M---Mo--------o--?-X-?---------o-----?---------------E------XE-M----X-----------E--X-
-?----E-?--|X?----o--B---?---XBM-X--o------XX?-----------B---B---M-----X--ME-M----?-X--B--E-E-------MX------Bo--?-X-?o------|---X-----o-------E-----E-Mo-----X---X--B-oEo------M-o--ME-B------B-----E-X-
-Xo-------B?-----E--o------X----oX----X-E-?B----?Eo----XE---------------B---o--------o-Eo---Eo----BX-Mo---?---------------X---X-XE-B----?--X?---E??--------BoB---X-----E-oEE----X--??--X--E---X-M-------
----------E-----M--------?--X-?X---------EBo---M--?E-o-----o-----B----X--o-XX-------------?----X-oM--MM-BX-E----B-B---o---BB-X-X--------E---Bo--------E----X-----EBE-M-------M----M----Eo--?-----M-?--B-
---X---X-----X------o--Eo-------E-MX--E----E-oX-XE-M--------?o--oM-X-B--------------BXB-X-E--------M--E-?----o-X---M?-----------X-----X----ooXX-----B-ME-X---------B--------B----E-X--M?---B--B?--BoME--
-----X-M--------M--BX---o--?----E-X--X----oX---E-------X-----?--------EM---BX--B-X--?--XX-X-M---------XE?--M-----X-----X-X--X-B-?X-o----E-X---M?--------XE----o-o-B---oX----X---------X-----B---?-------
---MM--?--o--o---EXXM-X-------M-X---E------oBXoEM------------oM-------X----E-oMXX-----M--X---MB-----------------X-----oX----X--X--E----X?o-----E----------o-M----------oXB----X-?--------M--------X?----
-X-?-----B----X----E-?-M--o---??----M--?---oB-M-------EBo------M--X--?o----X-?-----BX?-M-X?--B--oX----------M--------oX-B-----o---B---------?--M-----o---XEB-MX---------o------M-oMB--o-------?--XMo---v
---------E-?o?-----------ME-----Mo--------B---o--M---------oB--X-Mo---X---MBX?----------B--BE---------E--X---------BB--oXo----o-BE-------X------X---------------?-------------X---------------E-X------f
---?-M--E--o--------X-----?-----X---?---------------oB----?-----X-------MBE------------------X------BX?----X-o--Xo-BE--X--------?-M---B--?--?------M---B?-------MX?--o----B-Xo-----X-XM---M---X----?---f
-E-o-M--E------BE--X-----TM----?M?--XX-M-E-X-------ME---MB--X----------MX----------M------------B----------B--X--o-T-------X-B?MXEE----oX-B---E------E-E?-o-E---XM?--?-------M|--?-X-Xo-MB-------X-----f
-?-----B--Mo-E-B-----|B--|X---MM---M---MX---X-X--------M-XX-oX--------?------M------M--BXM--X----X--X-M-E-B-X----Eo|-M---?-MTo----X-oo-E--o----o-------------M-------o--o-X-E-TB---o---o--------?--M--?f
----?---X--T-M------TTTB-|Bo---|-?--T--oo-MT-T--|--BXX-T--------?-----X----T----M|-TT-----------B---------T------T-|T--XE?--|X----------B-X-----X---------T----M--X-M----B---X|XEXB-----X--B-M---E-Xo-|f
-X---?-X?X-|T-oXo--o|||--|-T---ToT-T||-T-TX|||-TTT---T-|---------T----X--T-|----BT-||--M?--T--T--T--MTXTTT|T-X--T|-||---T--X|E----T---TXTTTT-TM-?T-T-|X---|T-TTBT-----T----TX-|T---TEB-T--?--X----T-X-Tf
mTT-TTT-TTT||T-TT-TT|||To|T|-TT|-|-||TT|-|-|T|-|||T-T|-|TTTTT--T-|TTT-TTT|o|TTTTT|T||E-T--T|TT|T-|T-T|T|||||TT-T||T||T-T|TT-|TT-TT|--T|-||||T|TT?|T|TT-T-T||T||T|T-T-?|TT-T|-T||TT-|TT-|-TTT-T-TT-|TT-|X
X|||||||||||||||||||||||||||||||X||||||||||||||||||X|||||||||X||||||||||||||||||||||||X|||||||||X||X||||||||||||||||||X||||X|||X||||X||X|||||||||||||||||||||||||||||||||X||||||||X|||X|X|||||-||X|||X|X
