|E-|----X?oo--TB-E---|E----X?-E--?X-------T?--XE|E--o-|--T|-T---Bo---M--?--?----|------B-XM-?T-TT------XE||---XE-|--E-T--B?T-------T------?--T-BTE--EEM-B-?--E-|o-E--B---Eo--X-----E-B--E?-o--M--?|-Bo-B
?TX|T-?-----B-BEE-?-T?-------o|----BT---||Bo-E-----oX--M-Eo--BB--B---TE--XM-E-XTMB-MoX|--B|-TT--o--M-||--ETEE|X---o-E-o-MoEMo-?----M-X--|----oT----MXoT-M--X-EoBo----E-TE?----X--E-TXXoo--BE----X-?-o-oX
o---M?MT--M-XE--E-T--B|-MTTMB-BE-M-o--X-|XXX-----------E-?-T-M---|-?--B---EB--E-E-o------M-M--B-X---|B--E-oB---EM||---X|M---|---B---B?-B-----E--|-MEE-?-XE?--T-XXBT-BX---B--?-B--o------T-?---o--?M---Xo
?-|-T---B-T---EoTX-?--ME--E-Bo---B---MT|------o-X---M-----?BEEo---M-?-T-?MB?-|TE---T-B-EXE----o-M-B-B-ET|-------X---oT-||o-?-E--|-T-------T?-T?TX----?B-------?-|-|oT-B-X-?E------|EEMoXE|---BE---|-E--X
-|--T---?M----X-|-MXB-T-----o-?--MX-------BE---EB-M|--------M--MTM?XBE?---ETT------ME-Mo---TX--o-X?--o-BMB|T--oMo-?---B-|--?EE|-----MT----|XET---BX----E--X-?|-----M-------MoB?-oo-|----E-MB----T----E-X
E---B-|--T----XT-----T?--XoX-oB-o-XX-BMXX-----E-B----?-E--?--EX-?-M|--T?---|?X---E-MXB--M-X-|-o-MMX------?XEB---oo-----MB-Mo-------|-X-o--o-TBEX---o-X-----TE--||-|-B-T----M-o|o---?BoB-X-oE---|-M---?E?
o--?------oXM|?Xo|-MM----|-T-X|Mo?-?X-?|oT-ET-T--M--?--B--M-MEo?---M--X|-BT-|---o--o--------T-|-T--ooMT--?--TToX--TMT|--E---B?|?-------o--o-T--M--------M-TX-T-|-B-T----------T-B-|--||B-X---X-EE--?---?
E-?-|----XB-E-||--TT-XT----|TE-XB----|---M?----o|-----oT-----B-|X-oX---T----X--MB-X---B?|E--XMB?-X-M|X--T----BE--B|---X-E--M----T-|--|X-|-?|EBT---?B?|B-E----|-BM-----|--?-TXo|?--o-M?-|T-ET----|-o-M--v
M-M-oo--Xo-o-M|T--MX-TMo--|-TTo--?T---oo-oM--T--T|---Xo-----B-o-?B----T---E------|----B-Xo---?---B-XX-B-X---M---XEoXT--B--MM--?--X-T-E|----|--X----|X?-----MBo-??TTT--o--B?-X|-?--M-oTToM--T--|T||B-T-oX
MT-XT-BX--Eo?-----X-?E-B---?-?-?-X-B--T----T|-|BX---T---TT-Xo?B------B------MBT-X----?---MX?T--MXBXE----M--T?--B-----?T-|E-T-----T-?M---?oB--------M|--B-E---X--EEo---X-?BXX---||?-Eo-|-E|T-TBX----|o--?
?oX-----X--B-B-E-T-T---?--?-B--Mo------EEB---|TB--E---MMM-MoBBoB--XEM-EM-?---?-oB--|---M-?MX-----EXMT|-B--MMX---?--o-EMoX----oT-ME|-?|BTB---o-B--T-o-X--?XBX--E---||-EE------|XX-EE-M--X|---|-|---|M--o?
X|--B---?---|EX-oB--E--?----T----E-----XM-B-|---M---|-|----T-B-o-o-oo-E-To---T-|?ETM----E---o---oE----XE--E--|-ET?-X--M--M---X--oT----X-X--|-B---B---XM?E--E-||--o-E----BB----XT---B---?-M-?-?--?-M-?-TX
oMXM---M|E?B--E-T-X-E--E--ooTEToX|X-EoB---o---?TB|-?M----?--M-MMB|--o|EX?BEo--||B-B---XT-X-?T---?----?ET--TBE----?-E--X-TX------BE----E|EE--XM-|-M|B-oT?---E-|-E---------T-X-|-|-----M|-Boo---o--X-o-X?|
E------T-X----|-Eo--X-MB---EBEBM--Xo?-X--o--Bo-E---ET-o||-M-|--M--|?--?--B-?-----X-?M--E---Bo--TXX-?T-M---B-MM--T-M--TT?--M----?--X-E---o---o---|---B-E-X|E--ooo?o-T---MT?M|E||--Mo-?----|XE-BT|---B--BE
mB|------?E-M---oM---o---?X---M-|-B?T-X-?--MT?|----MBM-oBE-ooX?---oBBX-?--|---?-?XTEM-XE---?-o-M--?T-TE-----E-----XE--?--|-o|-??-o-----o--B-Bo--T--XM|-?TB--|-|o-o-------M--?|--|-E---T|--E----MM--TB|B-
XXXXXXXXXXXXoXXXXXXXXXoXXXXXXXXXXXXXXXXXXXXXXXXXXXXXXXXXXXXXXXXXXXXXXXXXXXXXXXXXXXXXXXXXXXXXXXXXXXXXXXXXXXXXXXXXXXXXXXXXXXXXXXXXXXXXXXXXXXXXXXXXXXXXXXXXXXXXXXXXXXXXXXXXXXXXXXXXXXXXXXXXXXXXXXXXXXXXXXXX
