--|------?X-?X--M-------X---E---oo--E------XoB-E-o----o-X-oXEX---?---E---oM-B--E--?-XEMMB-B|-o--X-E----oM-XX-?X-?--B--o---------Mo-X----|-X--o-o-----X-?o---------MM--X--E--MB-o--B-MoB|------E---o-Xo--
--?Xo--BoE----B|X-M|-E-|B--B-----?--MB-B----XX-----oB-EX--E-o-M--B--|X-XEoX-o-----X-----M--X|--o---XM?|---X-----M--?-Eo-EM---?-|M?M-----XM--E--?-o--?---X--M--------M-o?-?--B-M-X-X---oB----E--|--?Eo-E-
----B---?--oBXoM-|XM--EB--|--??---o??--o|--BX-B?E----o--o------B-E--X-|E-o---M------E-?X--E-M-MM--B-o-B--E-T----B---B------|-TB|--B---------o--E-ME-?ME--o-X-X-?o----M-B?--oEo-----E-?---B?----?--?-----
-|?---B-XXT--B-?-MEo----?-M----Bo-------|?---o---?XE--o-X-E-X-T--o----BE-----?|--?--o----o?---T-T----?-E-E-BE-X----EB---o--B-?BBB?-T|---o---M------B--|-----EEMo-B-oMoE-E------|------o---o?---?MX--X---
-??E-----??-T--B--o-------B--?E-X--EM--EB------?---o?|-E?|---MX-oo----?---E---MoX--ET------o-?X-M------o----|-----|--o----X-|E-M---MME--E-EX--o-------M-------M?----XB-----X---M--T---TME--TEM-Eo-X---E-
-MT----MT--B?-M---o----M?MXo----X-oMTB-Eo---B-?---E--|---|--E----XEM---T--E|T---EBT-?-E----E-------E--T|----??-Eo-|?-|----M-XoMo--?BB|---E-oX-E-B--------MET-XBB|-----B-EB-B-?----Mo-BM--o-?X----B-Xo-o-
-o??M-T??--?-EE--XXMo--------E-----MM--MoB-?-TEE?----?--oX--T-o-|B-oEo-BBo-||-MEM-MM---X-o-BET--X|T-T??MEM-ME-----X--B|--T-T-TEE--XETB--?--X?o?oEoE----o-oXX-XB-M--o-TM-?----MB---oB---o-----XM?B---o---
---BE||o-T---E--TE-T-|-TM-BM-oTE---E-T--X-|XM|----TE----XM--X--EM------B---||X--B--XE--BT---M|---||-Xo--------X----ETX?-|X-?MX--?-?-X---X-T-E-?--o---E-B-M--X--M-T?--?---B--E--TB-?E--T---T-----E-To--|v
-----|?M-XT-o-?-Mo-X|||B--MT-XX-----XX----MT-??---BB-E---B|?--MT--o----o---B?o-X---TM-EEB---EXMT-?|M?----XE------|XM|?X??-o-B---?XBXo--oX-B-oEX-T-|X-EoE?-o-T--TX?---o---o-E-?-ME-oB--|-M-?--M-?--|TBoMf
--M?-|-?--XXE--o--?-XXXo?TEB-B-T----M-|----?-------------B|BE--|Bo------T--BEo----B|--MBT--TEo?B-EX---B--XBX-T-|X??-XE-?Bo--E-B-------o|?MXo---TX?|---?---o-?-oX---oMBT------T--EMX---|o---?-TTXo-?|--Mf
--M-TM-o---BTT-?-ToXT----X?-|--?-M|--?X--E----T-TT-MTT|-E-XT---|M--?--Bo||M---TMX-B|T|BBB--M--?----T-----X-o-?-|EEE-X--TE---E-oE-TM-B-M|--XTT--X--B-----M-E-TT---BE-Eo|--o-T-|-M-o-M-X|-o---o?|--M?M-BMf
----BE---?--||---?--B----oE-|-E-o?|--o-----E--|T||o-B?MM-o-B---M---o----BM----XMMo?|X|---|XT----TXoXEEoE---XX--|-XTE?--M---T----o?M----X-T-|X-M-B----E-?-M-T|X--T-TE--?E-T-M-|--X---oTX-T-E-?TB-T---oEEf
-T-------o--MX---o-----Xo-M-BE?M--BT--------o-B||B---B--o-MM--X---o-T---------?--T?Bo|-XTX-|E-T?|-E--T-X--T-o-oB--M----MoT-??-o-?--T---B-|-|--T-oE--TTT-T-TM|--X|oM-o----|-T-X-M-o---B--|TMT-MB-|--T---f
-?T---TXT--o-MT-T-oo----?---?E-B-M-|?M--T-T?-??M??ToB---MToT-oB-o---|TT-EE---TX?-B--?|--M--BTM|EM-?--B--E?X----T--T--TM--|--TX-T---X-T--E|-B-|BE-T--|X|-|-|XM-X-|-M--oM-TX|?T---T--MT?-T||T|----|-BXT-Xf
mTBETT|T|-?--o|T|-BTT-TTTTTM-X-o?-T|ET?-|TM-oo--TX|--TTTE|MXBTT?--|T|B|T-M-T-B--M-TM?|TT-TMT|-|ToT-TTT-TToo-T-TMTTXXB|-MT?T-XTT?MoTTT|T-TMM--|-M-|ET?-|EB-XTXTT-|--TTEBT|M|-|-T-|TX-|B-||B?XEX--|TTT|--X
XXXXXXXXXXXXXXXXXXXXXXXXXXXXXXXXXXXXXXXXXXXXXXXXXXXXXXXXXXXXXXXXXXXXXXXXXXXXXXXXXXXXXXXXXXXXXXXXXXXXXXXXXXXXXXXXXXXXXXXXXXXXXXXXXXXXXXXXXXXXXXXXXXXXXXXXXXXXXXXXXXXXXXXXXXXXXXXXXXXXXXXXXXXXXXXXXXXXXXXX
