-o----T?E-T--M--------------M----------o---------------E?-oM---M-----?-B------B----------?---------B-M-----??-o------------------BE---?-------------M--B--------o-----------------X---X--o----E---------
--T---M-o-|--X---------------BM------M-----X-E-------B---------M---------o-------o--------X------------------?------------X-T-------------T--o--T-M-----X----------X---?------------M-M--M-------BX---o-
--M-------X---------o---------?-oo--B-B-------B--M-X-------o--------------B-----------oM-?-------------------?-----X--------X-----E---E--X?-----?---------E---M---------------------M?---X-------B------
-B-----T---------X---M-----?--X-----o---T--------?EE-M----?-------?------?---M-E-----------------B---M---------M---------------?--------E--o-BM--?---M---------------T----T-----X--------?--?-----------
-oT?--X?----------------------E-----X---X------?B-?-----M---?-----?--M-------------M----B---B--E-------M-----?---T--XB---B-??------?----M-------X--M---B---------BX--??---B---?-----o----?----------o---
-EM--E--M---B------T--M--------------T-------------XE-T-------------------B--M-----------------Bo----?-Xo------B-|-----o----oE---------?---X------T------Eo--EB------o----------E-------T---E-------?---
--------?--------o-X-----------------M----X-E---------?-----X-----E---E---Bo---X-o-----------E-?----X----X-E----XB------------o-B-E?--------------M-------------X---BB-----------------?X-----Xo------T-
---MoX-?E------E---o-------------o----B----X----------------X--------M--------M-B--------M-?E---X--------------o-X-E-M-----E----M--B-XE----?--------E-----M----?---E---------o?ME---B-B--M-----Bo-----?v
------T----B------------------X---------X-------X-o-------o-----?---------B------------------X-X------B------------?o-B--------------?--------E-B-----------M--E---B-X-BE------T-----M----M----TX-X----f
-EX-E-M----------------?---X--------------------M---EE---------B-------ME---oE---M------M-T?-o--------M--------?--------?---------B-----------E-E---X--B---------To--?M----o--oB------o-----?--M---?E--f
---E----------B---T--o----------X----------------B-------E----E---E----------o-------?----M---TB---------X--?----------------E----M--B-------------------------B-X--X---------------------------EB-----f
---------------E--MB----------M--------?--o-?--?---------?-T----------------E---B--X----?-----?----X-?----M-------?----------o---------------EM--------X--------E-------------T------E-------ME--------f
-----B------?----X----------------T----------X------M------M-----X------o---E--------E-------X------------------MB-------T---o-----M---------To-------------?-o--o-?--o-M-----XB---o--T-------------M--f
-----E-?--------T-----XE---B------X---BM-B-B-----------?-?X----------B--------------B---------?-------E----B-------------B--------X----------B---?-T-?--X----X-o---------?------------X----?-----------f
m-T----?---M----B------X-E--?--X--X------T--oXM--T--T------M----B---X-XX-Mo------------T------B---o-TXTM-o---M--?--------M--------M----------------|-B----E------------------T--X---------?-oB-o-B---X-X
XXXXXXXXXXXXXXXXXXXXXXXXXXXXXXXXXXXXXXXXXXXXXXXXXXXXXXXXXXXXXXXXXXXXXXXXXXXXXXXXXXXXXXXXXXXXXXXXXXXXXXXXXXXXXXXXXXXXXXXXXXXXXXXXXXXXXXXXXXXXXXXXXXXXXXXXXXXXXXXXXXXXXXXXXXXXXXXXXXXXXXXXXXXXXXXXX-XX-XXX
