---------?B-MB--------------M-E--?---------------|-------B--X-----XM---M---E--M---------M-?Bo----B-M--Mo-----|----E---------M--E-XM-----------------XE---T-----------XM---|-E------B----E-E--E----------
------T---E------MB----o--o--TM--------T--?---B--E-XBE-o----XBX---o-E----------------------ET-B-B--?o--------o---|-----X------------E--B-TT?--B------E----Mo--o-------X------oM---------T------?-oM-----
-E--EBo---|M--T--M---o--ET---o---|------------TBE-----T--XE-----M-|E-B--B--o---------B-E--|-----E-----T----?--|--?---------?--?----|-------------|------E--M?-MX-----------o----B-T--X--E-----?-X-o-----
-B----|B-T-------oX------------?-|-?---?-|------T-E--o-EE---------E--o|E|--?--|--o------B-o--M--X-?o----|M------|----T-M--|B----T-X------o---o-M?----E--|-------------------EEB--BX---o---|-M---oo----M-
-X---B----TETE--T-|o---------------oB----------M--T---------?-B----|---o|E-M-oT-|B--------------o---B--EB|----Eo-X------T|----|-----o----X-TE---E---?----|---|-----T--T-o----Xo---B--M-------M--------T-
-E------------M--|------M----X-MX------o--|?------|------B--X-X----------E--MT--------M---B------E----o--E-|o|-X------B-E---------|--Xo---X-MM-E--?----E--|-----o--|T---|------T-M-E---?XM--E----T-Bo?--
--?----B--------------T------Bo--|M-----------E-----oB--X----?-B-E----E---X-M-------?---BBo---o--------?--|-B----?-T---B----?------X----E---------|-X-TE-M---?--------M----o?------|T----B-E---?-|------
--------?XEE---------M---M----|-E-------B------oX---T-T-------X----E-------M----o--X---------o--------BM--T--|-o-----X-X------o-MT--oMo------o--T?|------B---|---TX-M---E-------B-?--o-----?---M-?X-|--v
------?-------------M-------X---?|----E-------M-M--TB--o------T-----|-X--EM-T------------X-E|--?|---X----------T|-----X?---?-------E|E------Xo----------M---o--oX-M-T---B-?T---E|--M?X-------o-T----T--f
-------MB-MX------T--M----E----E----o--B----------B---B---|Xo----B---?o-To-------o-----?-------B-----------X-M|---------X--------o-----B-B--------------|T-B---M------o--B-B---B-----E|------M--E--T---f
-M-E---E?----TB-X--?---o-X--E-----T--|-------B--------|T----M-o---XXE-X----T---T-|---|-X----|-X----------?B-XX---B---?|----------------|---B-T--?X--?X--------------?------BM-----|E|-----------oM-B--Tf
----T----|---------E-------T---T------B--M-?-E----B--M--MT|-B---o-------M----E---?----------|-?--------?-|-X--B--o---B-?---o---E?-?-E---X|--------E---o-B-|?B--BXTT-M--BX-M?---?-|E---M---------B---M-?f
---|---B--T-?X------?--M-----E---MX---|-----o--?-?B---o-T----------E-----M---|---------------?-o---?-T---?--T---To---E----B---M-------B--o----|-BX----T-?---------o-----------X-?-oTT---|--T---X----M-|f
-T----------|--|-----E--------B--E--------o?----M----M-E--X----|-X-----------o-----|------MX------EB----M-----B------M---|--M--------o----T----M------|?-EE-?---?----------M-B--oB-----------M?---B--?-f
m---M?-|E------TT-------?--------M------B---|----------o-------------|---------E-X---o--?---X---|------BTX-----o-----------X----?-E-T-----M--Bo--E---M----?-o--?---M--M-?B-------B--------E---X---XE---X
XXXXXXXXXXXXXXXXMXXXXXXXXXXXXXEXXXXXXXXXXXXXXXXXXXXXXXXXXXXXXXXXXXXXXXXXoXXXXXXBXXXXXXXE?XX-XXXXXXBXXXXXXXXXXXXXXXXXXXXEXXXXXXXXXXXXXXXXXXXXXXXXXXXXXXXXXXXXXXXXXXXXXXXXXXXXXXXXXXXXXXXXXXXXXXXXXXXXXXXX
