------------------------------------------------------------------------------------------------------------------------?--------------------------------------------------------M----------------------
---------------------------------------------------------------------------|----o?-----?----------------------------------------------------------------------------------------------------------------
------T--------E------------------------------------------------------------------------------------------------------------------------------------------B---------------------------------------------
--------------------X------------------------------------------------------------------------------------------?----------------------------------------------------------------------------------------
--------------------------------------------------------------------------------?-----------------------------------------------------------------------------------------------------------------------
------------------------------------------------M-------------------------------------------------------------------------------------------------------------------------------------------------------
--------------------------?-----------------------------------------|--------------------------------------------------------------------------------B--------------------------------------------------
-------------------------------------------------------------------------------------------------------------------------------------------------------------------|---|-------------------------------v
----|---------------------------------E----------------------------------------------------------------------------------------|----------------------T-----o------------------------------------------f
--------------E----------------------|---------------------------------X---------------------------T-------------------------------------M------------------X------------------------------------------f
------------------------------------------------------------------M---------------------------------T----------------------------------------------?------------------------T--------------------------f
------------------E-----------------------------------------------------------T----------------------------------------------------------------------------------------------------------------------T-f
---------------------------E-------------------------------------o-------------------------------------------------------------|--|------------------------X-------------------------------------------f
----------------------E-------o--------------M-------------------X---------X--------E----B-------------------------------o---E-------------------------T-----------------------------------------------f
m----------------T------------------------------------------------------------------------------------------------------------------------------------------------------X----------X-------------------X
XXXXXXXXXXXXXXXXXXXXXXXXXXXXXXXXXXXXXXXXXXXXXXXXXXXXXXXXoXXXXXXXXXXXXXXXXXXXXXXXXXXXXXoXXXXXXXXXXXXXXXXXXXXXXXXXXXXXXXXXXXXXXXXXXXXXXXXXXXXXXXXXXXXXXXXXXXXXXXXXXXXXXXXXXXXXXXXXXXXXXXXXXXXXXXXXXXXXXXXX
