-o----T?E----M--------------?E---------o---------------EM------M-----?-B--X---B----------?-----------------?-----BM---------B-----E---?---------------B----ME---M-----------------X----------o----------
------M-o---------------Xo----B---------?--X---------B-------------------o----------o---B-X----------o-------?-----E-E------TM---M------E---------------X----------X----?------oM-----M--M-------B----M-
--E-------M---------o---------T-o-------------B--M-X---M---o-------o-?----B-----X-----o--?-------------------------X--------X-----?------X--?T--?-------------M--------------------------o-M------------
----T-------------------------X--X--o---------M--?BE------?-?-----?--B-------M---------B-EoB-----B---M---------------o---------?------B------MM--?-------------E-----T-----------M-------?--?----E-T----
----B-X--------------??-------E-E---X---X------?------o-----------?-------------E-------B---B----M-----M---------T--XB---B---------?------------X-----------------X--?----B---?-o---o----?-M----B--?--?-
---------X--B---------M----------B---o----------------E----B-M-----M------?--M-X---M-----------B-E-----Xo-------------------o?X---M----?---X------X------E---EB------o----------E-----X-T-----------?---
---T----?--------o-----?------------------------------?-----------E----o-------X-o-----o-----E------X----X---------------M----o---B?B-------------B-------------X---B-----------------o?MM----XE------T-
--MM?X-?E------E-----------E--T-------B-----------E---------X---?-------------M----------M--E---X--------oM--?---X---T----------M--B----------------E--------------E---------o-M----B----------BM-----Xv
--M---T----------E----o-------B-----------o-----X----M----o---------------B------------------XEX------B------------?oM------------------------E-B-----------M?-E-------BE------T-?------------oTX-X----f
-EX--------------o-----?---X----T---------------M---EE-------?----------E---o----M-------M?--o-------------------------------------M----------EB------------M-E---o-T-M---oo---B-X----o-----?--M---?--of
---E----B----XB---T-Xo-----?----X-B--------------?----X--E--B-----E----------o------------M-o-T----------?--?----------------E------XB-------------------------B----X----B-------X---B----?---------T--f
---------------X--MB--EX---------------?--M-?--?-----B--T?-T--?-------o-?----B--B-------?---B-?----X-?------------??---------o--o----X-------E--Bo-----X-----X--E-------------B------E-B--E-B-B-----|--f
-----B------?----------------------------M----------M---M--M----------------E--------E--------------------------M------------o-----B----------o---------------o--o-?--E-------X----o---------M------M--f
-----E-X--------------X-M--B----M-----MM-B-B----------??-B-?-------T----------X----?---------------?T------?-------X---?-BX-T-----X------------------?--X-------BM-------?------------X----------------f
m-T----?---M----T------X-E-----X-EX--------B--M--T--T-----MM----B--M---X--o------------T--?---B---o-|X---o-----?---------M-BB-----M---X--------------B------T--------------------ME---?---?--B-o-B---X-X
XXXXXXXXXXXXXXXXXXXXXXXXXXXXXXXXXXXXXXXXXXXXXXXXXXXXXXXXXXXXXXXXXXXXXXXXXXXXXXXXXXXXXXXXXXXXXXXXXXXXXXXXXXXXXXXXXXXXXXXXXXXXXXXXXXXXXXXXXXXXXXXXXXXXXXXXXXXXXXXXXXXXXXXXXXXXXXXXXXXXXXXXXXXXXXXXX-XX-XXX
