------------?-------X---T--o-|M--E---?------XT-----M-?----X-|-------M---?----oB--o---|----E--X|-------------ET---M--oB-?--------B-------B----?-----M---------E------o--T----MMEE---o|-----X-B----T-T-MT-
--------M-----?-?T---XX----E-------oE----Xo----X-o----?-X-TT---X--|E--X-E----T-------------oo-T------o-------------M-----B-E-X---|----------T--EE------------|--E-M--E--EE------o---E-B-oBX-----To-M----
---------o---X|------TTE?--BT-E----o?M-B-----MM---------X-----------X|-------Eo---o-|--?-------------M------o--?-E----------X---TB----|B---|---|-----BM--B----MX-?-|M----?-?|----oX|---X----To--X-------
-X---------------o--E--E-E--EM--XE-?E----M---------M|--B--T--X---X--------?--EXE-B--|---T-E--B---B-?o-M--o-------E--M-o-EE---E-oE-----M-------E---------ME-----------------M---X---X----|-MEEB---oT--|--
-----B----M---|E--M--ToT--XX-----M-M-----B----E-----MMT-|----T--X----XM-E-----oX-----o-----X-?---BB--?ET----o--------B------o-----M----------E---o----E-?-|--oM-------Bo--M--|-----o------M-o------M-|M-
--B---E?MXEo---?----?---B---------E?---------------X-B----M------||?M|---B-X|-------M-----EB------------o------T-o-----BX--XB-M-ETX-M----o-M----E--T-oB-E?-o--?-T-o-----X----------T-----?-?---B--------
---oM---X-----oTM-?-B---?M--o-|---|-------X--------E-----?oE---B---E---------E--B--B-B--|--------------X--------------M--BB-------?--M-----?-XX---B--X----E---o--oB---E--------o----T-?------E---XT--M--
-B----ME-EBTX-X----MT-------------|-----o-------BE--X----?-B-----EE---BE--------T----X-?|-|------------|----o--??---M----?--M--------------E----------------oB----XX-?o----------|---X----o------o-----v
--M------E----------T|-------------T-------X-E-X---o-TM----oE?----------M------?-M----|--|----E-------o|-|B?-----?-X--B-------X--o----B-oM---T-T--E---------E--B--M-------B-B-?---M-|----X----E?------Tf
--B-o--------M?---o-E-----------o------B--EM-T--?----X--?---M----------o-B?---T---X-----o|E-T--X--EM?-------|MMX---o-?--------X-------B?-----E|-?E-B----------ToM-o------X---E-B?-M-E-------BT---------f
-T-MXB--MXX--B?---------B--EX---------T-|--XoBM----T--M---?o-----M-----XEX----|---B-B----o-----EB--------|--M-X-------------?-ETT-M-|------|oT----B----M--B------------EXo|EX-X-M--o--BT----MT------B--f
---E?--E---X-?|-------X-E----------B-o--Mo|--|--|-M-|B--o-o?M--EB--------E--------oM-T--oo----B?----------o--------XX-------To--B-------oBM---|---M----X-o-E|E-oT-EE-M------M--|-----X-?------T----E---f
-------------?-E-M-M-X--E----?-X?--|T--E-----X-oo--M------?----|------B---------E---?-?---T-------?MoXM----M------o----M--E----------?---B----E|-B-MX-T----M--M-------?T-?---BX-|----------o----B-|-X--f
--o--XB-T----M------M--------TT-----B-|---MM-?----E------B-E?oM------------E-M---E-E-|T---|-----?T----------o---E---XoBT--oX---B-------B---E-B-?--------?--------TE--X---Mo---T--TEo-T--B--E--?---M----f
m---M-----o?------X-?---T--T----MX---MM--------E--E-----B---?T-M-|TEMTB---?--------|?-----XM--B---E----M---B|B---?M--B---Mo--X----X?-|---M-M-B-X---?----B-X----E-----M---------M-T---BTEX-----|-------BX
XXXXXXXXXXXXXXXXXXXXXXXXXXXXXXXXXXXXXXXXXXXXXXXXXXXXXXXXXXXXXXXXXXXXXXXXXXXXX?XXXXXXXXXXXXXXXXBXXXXXXXXXXXXXXXMXXXXXXXXXXXXXXXXXXXXXXXXXMXXXXXXXXXXXXXXXXXXXXXXXXXXXXXXXXXXXXXXXXXX?XXXXMXXXXXXXXX-XXX-X
