-----|-M-X----------X-----oo-|M------?--o---X?--E--M-?----X-|E------M--------o---o---|----M--E|--M------?---ET---M--oB-?----T---B-------o-------|--M---------X--X--oB--T----MMEE----------o-B---|TET-MT-
--------------?-?T---XX-------X---|oE-B--Xo----XBo------XTTT---X--|--|X---M--T----?---------o---------------------TX-----B-E-X-X-|----------T-------X---o------EE-M--?--EM------o-----B-o|X------o-?----
---------o---X|X----|T-E?--BT-E----o-M-B-----M--B-----?-X-----------X--------Eo--Xo----?-------------M---------E-E----------X---TB----|B---|---|------M--o-X--MX-?-|Mo---?-?|----oX|---X-o---o--X-------
-X------E-----E--o--E--Mo|---M--X|-B-----M----------M-XB--T-----------E------E-E-B--X-----E--B---B--o-?--o-|--------M-o-EE---EXoE-------------?-----T---M-X--E-----M-------M---XE-T---B-|-METB----T--|--
----------M---|EM-M--ToM--XX-------------B-T--E--M--M-T-|E-----XM----XX-E--MB-oX-----o-----X-?---B?--?ET---Bo---------------------M----------E---o----E-?-|--oM-------B---M--|-----o---?--M-o------M--M-
------E?MX-o-------T?---B----------?----|----------X-B-o--M------||?-------X|-------M-----EBX-----B---?T-------T-o--X---X--XB-MXEoX-M----o-M----E--T-o--E?-o--?-T-Xo----X----T-----------?-?---B--------
--B-M----|----oTM---X---?M--o-------------X--------E-----?EE---B----------------B--B-BoE|--------------X---o---?------M--B------T-?--M-----|---------X----E-T-|--o-------------o----T-?-----ME---XT--M--
-?----ME-E-To-X----MT-----------X-|-----o----E--BE--X----?-------EE---BE--------T----X-?|T-o-----------|----o--??---M-------M--------?-----Eo---------------oB----XX-?o--------------------------------v
--M------E--T--T----T|-------------T----------oX---o-TM----oE?X---------M------?-M----|--|----E----M--o--|o-----------B-----EBX--o---oB-|?---T-T--------|-M----B--M-------B-B-------|---|XB----?------Tf
----o-----?T-Mo---o-E----M------o------B--EM-T--?---MX------M----------o-B----T---------o|E-To?X---M?-------|MME?----M--------Xo|-----B?------|-?E-B----------ToM------------E--?---E--o----BT----B----f
-M--X---M-X------X------B--o?----|------o-M--BM----X-------------------XEX-o--|Xo-B-B--?-o?-----B--------|--M-X-------------?-ETB--oX------|------B----M--B----M?---?---Xo-EX---M--|--?T---------------f
---E?--E---X-?|---------E----------B-o--Mo---|--|-M-|B--o-o?---?B--------B---oB-E-oM-T--oo----B?-------E------------X-------To------|---oB---M|---M----X-o--|E-o--EE-------?M--------T-?------T----E--Mf
-----B?------?-E-M-M-X--E----?-X?--|T--EoT---X-o---M------?----|------B---------E---?----ET--------MoXM----MM---?-o----M-|E---X---M--?---B-T--ET---MXET----M-----B-E--?T-X---BX------------o----B-|-X--f
--o--XB-T----M--------?------T-------------o|?----E------B-E-o------?------E-----E-E-|T----------T-----X-E------E--M-o----oo---B-------BM----B----------?---------E--X---M----T-XT------B--E--?---M----f
m---T-E---o--|----X-?-?--B-T----MXE--MM-----------------B---XX---|T-M-M---?--B--T--|?T-----?--B---E--E-M---B|-T--?---B----Mo-X-----?-|o--M-T---X-M-?--T---X--T-E-----M---|---|-M-T----TEX-----|-------BX
XXXXXXXXXX?XXXXXXXXXXXXXXXXXXXXXXXXXXXXXXXXXXXXXXXXXXXXXXXXXXXXXXXXXXXX-XXXXXXXXXXXXXXXXXXXXXXXXXXXXXXXEXXXXXXXXXXXXXXXXXXXXXXXXXXXXXXXXXXXXXXXXXXXXXXXXXXXXXXXXXXXXXXXoXXXXXXXXXXXXXXXXXXXXXXXXXX-XXX-X
