-X---oo--|-|-----|E---E---?|o---|TT-E--XX----M--o-o-X?E?-X--EE-B--M--o||-B??-B---M---BEE----X-o------E-M---M---E-T-o------E-MX----T?|oo--X-M|--------?B-----XM---M-oT---|-||-?-|BT----|EB--------|--B-B-
-EM--TT--|BooT-|-M-M--T---X--oB-------oo-B?-----T----E--T--o---TM-|oX|TX|-----E--o?|---??--X--o-Bo-|-E-MBB?--o-MTETB----To-E?---M-X-Mo---o-X-----E--|BM---X|ooM|X--B-B-X-|----ooM-?--o----TT-|---XM-TE--
----o?-?--E-E-?-o-|o--|M|oX---TBMo-||MT-T--T----X|BX--|o|-Mo--TX-EX---|E-T----o--?--?o---B---M|-----|-|B|o?|MT-B-?-oo?T--o---XB?M------o-|----M??-B---?-Eo--o---------|---XEo--M--E--?-|---MM?-?MX--o|M-
-----T--TB-----EX-B-E-|-ME|-BXM--Xo-X-MTE--M-o-o-BM-X-|XX-B-E-M-------EE-M--?B----E-----XX---Xo-o-o---EM--|-T----|-|oT|-B-M---------TT-E-M-M---M---B---BB-|X-B?---T----M-M---BX-M?M-TB-E-----|-----?-X--
--Bo-|-|X-E-?--o?M---?X-E---o|-XM|B-X-|?--------ETE|X-B-o--B-B----X---o-oME??|T?--TTo-------o--o----T-X|-M--o----BB-||o-----o?-----|-BB-|-E--EM-o-TXMX?--MXMXToE--o-Bo-T??-M|-EBBT-E----T----?B---X|-?|-
--|MTX-o-|--T-E---|--XT--BMo-o-----?o-?|-----E-M-|o?---------oT-E---B-B--|--------M-B--|||X-----MMB----M-X-XM-EM--Eo----X-XTX-MX|--B-o-M----T-?--|T-------XE--B-|-X---E--B--B--?--B---X-Bo--B-oBMB-o--X-
--T-EB-?-o-BT--XMB----E-BT-X-o--|--T?B-T-o?-?--|---XX---E--?|M|-?--o--M-????BE-oETT?o--TX--ME--MB----E--MB-M|?T-----M-XBBM-TMEX--|-T-EoE-?-T|-T-|X---T-X-B--|-oX??BB|-T?X-|--X-o-T--------M-Mo??E-X--oB-
---oB-EXMEE---M|--|---?o--M-|?-ET?-----------M--T----?M--oX-T?o--o-XM|-----?o---E-TT-?-oE---T--oM?-EoX-oB--M--EEX-?XX-X-B---|o-?o-|B?-|o-?X-?BT|---?-M|-Eo-ET----------M---T?-X-|T---ET-B--TM--|--MoXoov
--oB-BTTM---B--|-M-BBo-?-----o--|???--|-EBT-?--E-oEX?-M-X-|M-B-MEB-----B--B---T-oX?-M-o?-BM--BBB-E-|||E--o-----BT-?E-BM--??oM--E--|B-X-----T--M-?M----EX-T-M--oTX?----M-o-o-T--X---|T-M-X-BM|-M--||-oo-f
--X------XTooEM?-B?|---o----X-?-M--Eo---?-T-|---?-----B--------?o--?M--M---o??o-B--|-?--X-|?ME-X-M-T-B---|-EMoE-XBoMM---MT-E-E-E-oT-T-TEE--o?E---M-?-BE-?-M--Xo--|--M?----BTM--TX-E---T-----|-X?M---TM-f
-M-BT--oT-E-XT-E--|--E-------B-T-----M--BT-ooMT--XX-o-o-M-T---oM---?B--oBT-|--o?T-X-----o-TB?-----EB--o-X-oE------B-oE-BM--??-T---M-|--|o-?-o--?-----|XBX??-M-----M------T----B----B---BTT-X-E-BXB-E--of
--?|-X-T--oEE--BM-B-M--M--|-E--|-ET-|-o-----XE---o??o?oo-o-B|-B----|-X-----B---B|E----|---o---|E--BTT-----EE--MB---E-E---X----|E----M----To|E|-----o--T?X-?o-oBBM--To-?M-X--E-X-|--XoT---XB-o---|o||--Bf
---EXo-T-----T-o-E--T?--TBo--o---M-TX|--o-M?-------T---|-X-T-T-MT----XM--?X?----X--E-ToE--E|------o--M--|?-Xo-------B--|--------E-||-BooE--??o----|--|--?-BoM-M-T-o-X--E--E?BBoXX--------B-?-|-oB---B-Bf
----T-E|---M-?-EXEM-|-?T?-o--o---BTB|oBX-|o-|--M--|-|X---XX-----|--?-----|-|?-|-|-M||-E-----X--XM-B--------B--XE|XB----?---X-X------|-X-|-o-X-X-B-B--?o?--MT-|-MM----?oBT-?X?-----------X-X--EMB--B---of
m-MB-?oE--MEMEX|---M-?---X-T--|E-----T-------T-M|-X-M----M--T|--M?---E-MM?TT?------TMo-BB--X----BT--?T--?XB--?M|T?-oTBE---|BBXT-B?MX-----?T-??----Bo---?|-|-?E---BM--E-----?------o-M---o-Mo----X-X-X--X
XXXXXXXXXXXXXXXXXXXXXXXXXXXXXXXXXXXXXXXXXXXXXXXXXXXXXXXXXXBXXXXXXXXXXXXXXXXXXXXXXXXXXXXXXXXXXXXXXXXXXXXXXXXXXXXXXXXXXXXXXXXXXXXXXXXXXXXXXXXXXXXXXXXXXXXXXXXXXXXXXXXXXMXXXXXXXXXXXXXXXXXXXXXXXXXXXXXXMXXX
