-o----T?E----M-------------B?E---------o---------------E---M---M-----?-B-----?B----|-----?-----------M-----??-?---------E-------------?---MBM-----T-M------ME---M----------------------------o----------
------M-------X-----------X--BB------M--?--X-X-------B---------M---------E--------MX------X-----------T------?------------X-TM--BMX-----E---------M-----X----------XB--?--o----oM-----M----------BM---o-
----------M--------M------------Xo--B-B-------B--M-X---------------B-?----------------o----------T----X--M---B-----X--------X--------M---X------?-------------M--------------------------X-------M------
-B-------------------------?-?X--X--o---T--------?-E--------?-----?----------M----------B--------|-?-M---------------M-----------X-----------BM--?---M-B-------------T-------oT----------?------?E--o---
--T?--X?-------M-----??-?-----E-E---XM--X------?--------------B---?--M----------E-------B------E-M-----M-----?------XB---B-?-------?--------?---X--M------?-B-----X--?----B---?----Xo----?------B---o---
--M--E------B--X------M?---------------------------XE-E-------------------?--M-----------------B-E---?-Xo--------------o----o-X---M----?---X------X---M------EB-----To-----B----------------------X-?---
----X---?--------o-X-------?---------M------E---------?--E--X-----E---E---Bo---X----M------o-E------X----X-------T-------B----o------------------XM-----B-o--?--X---BB--------E--?----o?X-----XE------T-
----?X--EM-----E---B-------E------X---B----------EE-----o---X-----------------M-M--------M--E---Xo---X----M------X---M------------M--M--------------------------------------M-??----BT---------BB-----?v
------T----M---------------M--BB?---------------X-----o--------------X----B--------o----------E-------B-----o------?o-B-------------X---------E-B?----------M--E----T-EBE------o--?--XB---ME----X-E----f
-EX--o-----------o--M--?--------T---------------M---EE--B----?---------ME-B-o----M----?------o------------------------------------B------?----E-E------B--------?-o-|?-B?-oo---B-?----o---T--------?--of
---E---------XB---TT-M-----?----X-B--------------?-------E----E---E----------o-X-----M----M-o--------X-----------------------E-------B--------X--------------T-B----X--------?------------B------B---E-f
---------------X--M---EX------B--------?--M--------------o-T--?B----------------B--X----?------------?-o-----------------?---o--------------BE--B------X-----X--E---------M---T----o-E-BB---X-E--------f
---M-B------?------------M-------------------------oM------M---------------BE------------?-M--------X-----E-----M---------------?--M?--------To----------X-------o-?-Eo------?X---------------------M--f
-----E-----M--------?--E---B------B----M-B------------??-B-----------------------------------------?T-E----------M-X-----M-----------------M-B-------?--X-------------?--?------------X----------------f
m-TX---?------M-B------X-E-----X-------------XM--T---------M----B---X--X--o---?-----o--T------T---o-|--------M-----------M-B------M---X------------T-B--------------X--------T----E------BT-oB-oTB---X-X
XXXXXXXXXXXXXXXXXXXXXXXXXXXXXXXXXXXXXXXXXXXXXXXXXXXXXXXXXXXXXXXXXXXXXXXXXXXXXXXXXXXXXXXXXXXXXXXXXXXXXXXXXXXXXXXXXXXXXXXXXXXXXXXXXXXXXXXXXXXXXXXXXXXXXXXXXXXXXXXXXXXXXXXXXXXXXXXXXXXXXXXXXXXXXXXXXXXX-XXX
