----------------------------------------------------------------------------------------------------------------------------------------------XXXX------------------------------------------------------
--------------------------------------------------------------------------------------------------------------------------------------------------------------------------------------------------------
-----------------------------------------------------------B-M-------------------------------------------------o----------------------------------------------------------------------------------------
----------------------------------------------------------------------------------------------------------------------------------o---------------------------------------------------------------------
---------------------??---X--------------------------------------------?---oo--oo-----------------------------------------------------------------------------------------------------------------------
-----------B-------B-----XX-----------------------------------------------------------------------------------------------------------------------------------------------------------------------------
------------------------XXX-------------------------------------------------------------------------------------------------------------------------T--------------------X--------T----------T----------
-----------------------XXXX-------------------------------------------------------o-----------------------------------------------------------------|-------------------XX--------|----------|---------v
----------------------XXXXX-------------------------------------------------------------------------------------------------------------------------|------------------XXX--------|--?-------|---------f
---------------------XXXXXX-----------------------------------------------------X------?------------------------------------------------------------|-----------------XXXX--------|----------|---------f
--------------------XXXXXXX-------------------------------------------------------------X---------------------------------------------X------------T|----------------XXXXX--------|----------|---------f
-------------------XXXXXXXX------------------------------------------------------------------------------------?-------?-----T-------XX---T--------||---------------XXXXXX--------|X---------|---------f
------------------XXXXXXXXX-------------------M--------------T---------------------------------------------------------------|------XXX---|--------||-------------TXXXXXXX--------|XX--------|---------f
-----------------XXXXXXXXXX---------------------M------------|---------------X------------X----------------------------------|-----XXXX---|--------||-------------|XXXXXXX--------|XXX-------|---------f
m---------------XXXXXXXXXXX----------------------------------|----E---X-------------------XX---------------------------------|----XXXXX---|--------||------------X|XXXXXXX---E----|XXXX------|---------X
XXXXXXXXXXXXXXXXXXXXXXXXXXXXXXX-------XXXXXXXXXXXXXXXXXXXXXXX|XXXXXXXXXXXXXXXXXXXXXXXXX---XXXXXXXXXXXXoXXXX-----XXXXXXXXXXXXX|XXXXXXXXXXXX|XXXXXXXX||XXXXXXXXXXXXX|XXXXXXXXXXXXXXX|XXXXXXXXXX|XXXXXXX?XX
