--------------------------------------------------------------------------------------------------------------------------------------------------------------------------------------------------------
--------------------------------------------------------------------------------------------------------------------------------------------------------------------------------------------------------
--------------------------------------------------------------------------------------------------------------------------------------------------------------------------------------------------------
--------------------------------------------------------------------------------------------------------------------------------------------------------------------------------------------------------
-X--------------------------------------------------X------X-----BBBB---T--------------------------o-----------------------------------------X---------------------------------------X------------------
-------B-------------------------------------------XX-------------------|-------------------------------------------------------------------XX--------------------------------------XX------------------
-----------------------------------------------T--XXX-------------------|------------------------------------------------------------------XXX-------------------------------------XXX------------------
-----------------------------------------------|-XXXX-------------------|-------------------------------------X----------X----------------XXXX------------------------------------XXXX-----------------v
-----------------------------------------------|XXXXX-------------------|------------------------------------XX---------XX---------------XXXXX-----------------------------------XXXXX-----------------f
-----------------------------------------------|XXXXX-------------------|-----------------------X-----------XXX--------XXX--------------XXXXXX----------------------------------XXXXXX-----------------f
----------------------------------------------X|XXXXX-------------------|----------------------------------XXXX-------XXXX-------------XXXXXXX---------------------------------XXXXXXX-----------------f
------------------o--------------------------XX|XXXXX-------------------|-X--------T----------------------XXXXX------XXXXX------------XXXXXXXX--------------------------------XXXXXXXX----------------of
--------------------------------------------XXX|XXXXX-------------------|----------|---------------------XXXXXX-----XXXXXX-----------XXXXXXXXX---------------------T---------XXXXXXXXX-----------------f
-------------------------------------------XXXX|XXXXX-------------------|----------|--------------------XXXXXXX----XXXXXXX----------XXXXXXXXXX--------M------------|--------XXXXXXXXXX-----------------f
m-----------------------------------------XXXXX|XXXXX--E----------------|----------|---------------E---XXXXXXXX---XXXXXXXX-E-------XXXXXXXXXXXE--------------------|---E---XXXXXXXXXXX-----------------X
X---XXXXXX-XXXXXXXXXXXXXXXXXXXXXXXXXXXXXXXXXXXX|XXXXX-XXX------XXXXXXXXX|XXXXXXXXXX|XXXXXXXXXXXXXXXXXXXXXXXXXXXXXXXXXXXXXXXXoXXXXXXXXXXXXXXXXXXXXXXXXXXXXXXXXXXXXXX|XXXXXXXXXXXXXXXXXXXXXXXXXXXXXXX----X
