-----|------?-------X------o-|M------?------X?-----M-?----X-|E------M-----T--oB--o---|----M--E|--M------?---ET---M--oB-?----T-?-B-------B------X|--M---------X--X---B--T----MM-E----|-----o-B----TET-X--
--------------?-?T---B------------ToE----XoX---X-o--E---XTTT---E--|--|X---M--T----?--------oo-T---X---------------TX-----B-E-X-X-|------X---T--EE---X----------EE-M--?--EE------|-----B-o|T------o-?----
--X------o---X|X----|T-E?---T-E----o-M-B-----M--B-----?-X-----------X--------EoT--o----?-------------M-M-------?-E----------X---TBX---oB---|---|------M-------MX-?-|Mo---?-?|----oX|---X-o---o--X-------
-X------E-----E--o--E--Mo|---M--X|-B-----M---------MM--B--T------X----------TE-E----X---M-E--B---B--o-?--o-|---B----M-o-EE---EXoE-----------------------MEX--E-B--T------?--|--X--T-------METB----T--|--
----------M---|E--M--ToM--XM-----------B---To-E-----M---|----T-XM----XX-EM-M--oX-----o-----X-?---BB--?ET---Bo---------------o-----M--------------o-B--E-?-|--o--------B---M--|---B-----?--M-o------M--M-
--B---E?MX-o---?---T?---B--------BE?---------------X-M----M------||?-----B--|-------M-----EB------B----To------T----X---X--XB-MXEoXoM------M-------T-o--E?-B--?-T-o-----X----------------?-----B--------
--BoM----|----oTM---B---?M--o-|-----------X--------E-----?-E---B----------------B--B-B--|------------------X---?------M--B-----------M-----?---M--?--X----E-T-|--o-------------o----T-------ME---XT-EM--
-?----ME-EBTX-X----MT-------------|-----o----E--BE--X----?-------EEB--BE--------T----X-?|T|o----------||----o--??---M-------M--------?E----E---------X------oB-----X-?o-------------------o--o---------v
--M------E--T--T----T|------M-E----T-----------B---o?TM------?X---------M------?-M----|--|----E----M--o-E|------------B-----EBX--o----B-|?---T-T----X---|-M-E--B--M---------B-------|--M|XB---E?---M--Tf
--E-o-----?T-Mo---o-E----M-------------B--EM-T--?---MX------M----------o-B----T---------o|--T-TX--EM?-------|MM-?--o-M---------o------B?------|-?E-B----------T-M-o----------E-B?-M-E--o----BT---------f
-M-MX---MXX------X-----oB--X?--T--------|---oBM----X-------------M-----XEX--B-|X--B------o?-----B--------|--M-X-------------?--T--Mo|?-----|--o---B----M?-B----M?---?---Xo-EX-M-M--|--?T----M-------B--f
---E?--E---X--|-------X-E---------------Mo------|-M-|E--o-oE---EB------?-B----B---?M-T--oo-----?-------X------------X-------To--B---|----B---MM---M----X-o-E|E-oT--E-M-----?M--|-----T-?------T----E--Mf
------?------?-E-M-M----E----?-X?--|T--EoT---?-oo--M------?----|------B---------E---------T--------MoXM----M----?-o----M-|E-------M--?---B----ET---MX-T----M----------?T-X---BX------------o----B-|-X--f
--o--XB-T----M------M--------T--------|----M|?----E------B-E-o------?------E-----E-E-|T---|------T-------------------T-T-|ooB--B-------BM--E-B----------?--------TE--X---M----T-XT---T--B--E--?---M----f
m---M-M---o--|----X-?-?-T--T----MX--EMM-----------------B---XX---|TEM-B---?------MT|?T-----M--B---E--E-M---B|BT--?M--B---MooXX-----?-|---M-T--oX-M-?--T-B-X--E-E-----M-------|-M-T----TEX-----|--T---EBX
XXXXXXXXXXXXXXXXXXXXXXXXXXXXXXXXXXXXXXXXXXXXXXXXXXXXXXXXXXXXXXXXXXXXXXX-XXXXXXXXXXXXXXXXXXXXXXXXXXXXXXXXXXXXXXXXXXXXXXXXXXXXXXXXXXXXXXXXXXXXXXXXXXXXXXXXXXXXXXXXXXXXXXXXXXXXXXXXXXXXXXXXMXXXXXXXXX-XXX-X
