-o-oM---?-------T--M-----|M-------T--------M|-----M--BB?----M---------BE--B--E-----X----To-------E?------?-o-|-?-----------o-BB--------X--|----X--------------------?-----B-E----M-T-?--T----E-|-Xo-----
-----|--TM|o-o-----------M--T-|-XoE-X--E-----T-------B--------X---?--?----TM-------M---E-------------o----T|-----|E--E---M-------M--|--o---BB----M----------B?-?--X---------|B-E---T------B---------E---
-X-Eo---M------?EB-----------B----XM------E?--------T--?-----------------B-B---o------|--X--|M------T----|---E---TE??-----?-TE--E-----X----|-XE--------M--E----------?-B--M------B--B-----o------|---o--
-----?------X--X----o--|--B---XM------Xo--T-E----B?---T---EX--o----|--?-------XMB---------E---------?-----TX---E----TB--E--B--T----|------M-----M---B------T---M-T----M-XX----T--B---M-----oT----B-|?---
----B--B------X--------B--------?------T---|--X--X-|---E?--ME---B-|--E-T--X---T--?----------B-M----------o?----X------o-X--E------|o--B-B-------MM-oXM---?--M--M----X--MT-E?|----TM----------E----------
-X----B----oX|------E-M-o----------|-|--------|--------o---E--T----B-M----?-B----X-o------B------|-?-E-------B-M-------M---?-----o--?--o---------Mo-X---X---------------T--------------o|-T--------|----
-E---------E-----o-E-o-B--|----ME---------X--|X--TT-------M---|---T-T--X-?--?----E--E--X--------B--?-------E--BB-----B--B-M--------o---------------------BB--------B--?--?----|------B-TM-----M----?--|-
--B---|-X-------------Eo----B?-T---o----------------T----------E---------------M-------oT-------|E-------B--------M--E--------T-----B------B---|o---------MX-----------X---------|--?----|--X---X------v
-X--MT-EX|B----------T---X--T---TT---------------------------E--B--o---------X-X-------?---MM-----o---X-E---?-----E--M----------TB--E-T----o------------E----X-o-----X----|B?--E--|B|--T-T---M------E--f
---B-----T-T--X--M--B-o---M--------M----------?-BETEM-|---?-o----T-o------------M-T---------T-E--M-------------ET---X----o-ME------E--Eo---------|---MM----o------XB-------B-o-----o--?-----B--M|---BBof
-----------|--B--M-M--------E-?E------------o--------------E-------o-------ME--X----|--B---------------|----E--|MT---------B-------------------?----T-o--o-o--E-o------T--X--------X-----B-------------f
---X-B--------------T-o--------X-?----------E----|---M----T--T-T-----XT-M---M--E?M----------o----E--o----TT------E-B-T-----?M--B----B-----------|--------------o---T--E--?-T---M----?-X?-----?-----|---f
--------M------B-------E-----------B-EB----T------?--E-----?--|o?-o---|-----o-------E-X------?---TTX----?-----?T-T---X-----------X-----------?X-B------B|--------E---------o-----E--------B------------f
-B--?|-?---|-------------M--|-B------X-----Mo?--X-M---E----o|T----M------o------------M----X------T---------------X-X--B-------B--|--|---------B-----------o---M-o?-----B-TB----XB-----------B-X-------f
mB-oX---o---------B-----?--------M-ME---M-B-B--M-|-E----X-------------|?-|--X-|--XX-----T?-------o--E----M--T-E-o-X-----------------o----o??-----------------B---E----?X---------M--B--B-EB?--BT-------X
XXXXXXXXXXXXXXXXXXXoXXXXXXXXXTXXXXXXXXXXXXXXXXXXXXXXXXXXXXXXXXXXXXXXXXXXXXXXXXXXXXXXXXXXXXXXXXXXXXXXXXXXXXXXXXXXXXXXXXXXXXXXXXXXXXXXXXXXXXXXXXXXXXXXXXXXXXXXXXXXXXXXXXX?XXXXXXXXXXXXXXXXXXXXXXXXXXXXXXXX
