--------------------------------------------------------------------------------------------------------------------------------------------------------------------------------------------------------
-----------------------------------------------X--------------------------------------------------------------------------------------------------------------------------------------------------------
--------------------------------------------o-----------------------------------------------------------------------------------------------------------------------------------------------------------
--------------o---------------------------------------------------------------------------------------????????--------------------------X---------------------------------------------------------------
-----------------------------------------M---------?-----------------------------------------------------X---------------------------------------------------------------------------B------------------
-------------------------------------------------------------------------------------XXXXX--X-----------------------?-----------------------------------------------------------------------------------
-------------------------------------------------------------------------------------------XX----------------------------------------------------------?------------------------------------------------
------------------------------------------------------------------------------------?-----XXX---------T--------------------------M---------------------------------------------------------------------v
-----------------------------------------M-----------------------------------------------XXXX---------|------------------------------------------------------------------------------------------------f
-----------------------------------------B----------------o-----------------------------XXXXX---------|---o---------------------------------------------------???????----------------------------------f
----------------------------------------------X------------X-----X----------B----------XXXXXX---------|-------------------------------o----------------------------------------------------------------f
---------------------------------------------XX-----------XX-----XX-------------------XXXXXXX---------|------------------------------------------M----------T------------------------------------------f
-------------------------------------------XXXX----------XXX-----XXX-----------------XXXXXXXX--BBBBBB-|-----------------------------------------------------|----------------T-------------------------f
---------------------------o---------------XXXX---------XXXXXXXXXXXXX---------------XXXXXXXXX---------|-----------------------------------------------------|----------------|-------------------------f
m-----------------------------------------XXXXX--------XXXXX--E--XXXXX-------------XXXXXXXXXX---------|-------------------------------------------------E---|-E--------------|-----------E-------------X
XXXXXXXXXXXXXXXXXXXXXXXXXXXXX-----XXXXXXXXXXXXXXXXXXXXXXXXXXXXXXXXXXXXXXXXXXXXXXXXXXXXXXXXXXXXXXXXXXXX|XXXXXXXXXXXXX-----XXXXXXXXXXXX-------XXXXXXXXXXXXXXXX|XXXXXXXXXXXXXXXX|XXXXXXXXXXXXXXXXXXXXXXXXXX
