-----------------------------o--------------------------|----------------------------------------------------B------------------------B----X-------------------------------------------------------X----
------------------------o------------------------------------T-----------------------------------------------------------------------------------------X------------------------------------B-T---------
-----------------------M--------------------X----------------------?---------E--------------------------------------------------------------------------------------------------------------------------
---------------------------------|------------------------------------------------M---------------------------X-----------------------------------------------------------------------------------------
--------------------------------E-----------------------------------------------------------------------------------------------------------------------------------------------------------------------
---------------------------------------------------------------------------------E-----?-------------E----------------------------------o---------------------------------------------------------------
----------------------------------------------------------------------------------------------------M-----------------------------------------------E---------------------------------|-----------------
-----------------------|----------------X-----------------------------------------------E--------------B-----------------------------------------------------------------------------------------------v
-o--------------------------------------------------------------------------------------------------------T--------------------------------------------------------------------------------------------f
-------------------------------------------------------------------------------------------|----------------------------------|------------------o-----------------------------------------------------f
--------------X----------------------------------------------------------------------------------------------------------------------------------------------------------------------------------------f
------------------------------------|---------------------------------------------------------------------X--------------------------|--------X----------------------------o---------------------------f
-------------------X--------------------------------------------------------------------------------------------------------------------------------------B---------o----------------------------------f
------------------------------------------------------------------------------------------------------------X------------------------------------------------------------------------------------------f
m-------------------------------------------------------------------------M----------------------------------------------------------------------------------------------------------------------------X
XXXXXXXXXXXXXXXXXXXXXXXXXXXXXXXXXXXXXXXXXXX?XXXXXXXXXXXXXXXXXXXXXXXXXXXXXXXXXXXXXXXXXXXXXXXXXXXXXXXXXXXXXXXXXXXXXXXXXXXXXXXXXXXXXXXXXXXXXXXXXXXXXXXXXXXXXXX-XXXXXXXXXXXXXXXXXXXXXXXXXXXXXXXXXXXXXXXXXXXX
