-----|---X----------X------o?|-------?------X?-----M-?----X-|-------M-------XoB--o---|----M---|--M------?---ET---M--oB-?----T-?-B-------B------X---M---------E--X-----BT----MM-E----------o-B----TET-MT-
--------------?-?T---XX------BX---XoE----Xo------o------X-TT---E--|---X---M--T----?--------oo-----X--o------------TX-----B-E-X-X------------T--E----X---o------EE-M--?--EM------o-----B-o|X-----T--?--o-
---------o---X|X----|TTE---BT-E----o-M-B-----M--B-----?-X-----------X--------EoT--o----?-------------M---------?-E------E---X---TBX---|B---|---|------ME-o-X--MX-?-|-o---?-?|----oX|---X-o---o--X-o-----
-X------E--------o-----Mo|---M--X|-B-----T----------M--B--T--X------------?--E-E---EX---T-E--B---B--o-?--o-|--------M-o-EE---EXoE---o---------?---------M----E----T------?-M---X----------METB----T-----
----------M---|EM-M--ToM--XX-------------BBTo-E-----MM--|------XM----XX-E--MB-oX-----------X-?---BT--?ET---Bo--------------Bo-----M-----------X--o----E-?-|--o--------B---M--|-----o|--?--M-o------M--M-
--B---E?MX-o---?---T?---B---------E?---------------X-B----M------||?-----B-X|-------------EB------Bo--?T-------T-o--X---X--XBEMXEoX-M----o-M----E--T-o--E?-o--?-E-o-----X----T-------X-E-?-?---B--------
---oM----|----oTM-------?M--o?|-----------X--------E-----?-E---B----------------B--B-B-E|--------------X--E----?------M--B--------?--M-----|---M-----X----E-T-|--o------------------T-?-----M----XT--M--
-?----ME-E-TX-X----MT-----------X-|-----o----E--BE--X----?-------EE---BE--------T----X-?|T-------T-----|----o--??-M-M-------M--------?-----Eo---------------oB----XX-?o-------------------o------------v
--M------E-----T----T|------M------T-----------X-----TM----oE?----------M------?-M----|--|----E-?--M--o-E|o-----------B-----EBXE-o----B-|?---T-T--------|-ME---B--M-------B-B--?----|--M|XB---E?------Tf
----o------T-Mo---M-E----M------o-|----B--EM-T--?---MX--------|--------o-B----T---------o|E-T-T---EM?-------|MM----o-M----E---Xo|-----X?------|-?E-B------------M-o----------E--?--|E--o----BT---------f
-M--X---MXX------X-----oB---?----|----T-|---oBM----X-------------------XEX-o--|X--B-B----o?-----B--------|--M-X-------------?--TT-M-|?-----|------B----M--B----M?---?---Xo-EX---M--o--?T----MT---------f
---E?------X-?|---------Eo---------B----Mo---|--|-M-|B--o-o?---EB--------B---oB-E-?M-T--oo----B?-T------------------X-------To------|---oB---MM---M----X-o--|E-oT-EE-------?M--|-----T-?------T----E---f
------?--B---?-E-M-M----E----?-X?--|T--EoT---X-oo--M------?----|------B---------E---------T--M-----MoXM----MM---?-o----M-|E-------M--?---B-T--ET---MX-T----M--M--B-E--?T-X-X-BX------------o----B-|-X--f
--o--X--T----M--------?------T-------------o|?----E------B-E-o------?------E-----E-E-|B---|------T----------o------M-o----oXB--B-------BM--E-B----------?--------TE--X---M----T-XTE--T--B--E--?---M----f
m---M-----o--|----Xo?-?-T--T----MXE--MM-----------------B----X---|TEM-B---?--B--T-|E-T-----M--B---E--E-M---B|BT--?M--BM--Moo-X-----?-|o--M-T--oX-M-?o-T-B-X--T-E-----M---|---|-M-T----TEX-----|--T---EBX
XXXXXXXXXXXXXXXXXXXXXXXXXXXXXXXXXXXXXXXXXXXXXXXXXXXXXXXXXXXXXXXXXXXXXXX-XXXXXXXXXXXXXXXXXXXXXXXXXXXXXXXXXXXXXXXXXXXXXXXXXXXXXXXXXXXXXXXXXXXXXXXXXXXEXXXXXXXXXXXXXXXXXXXoXXXXXXXXXXXXXXXXMXXXXXXXXX-XXX-X
