--------------------------------------------------------------------------------------X---------------------------------------------------------------------------------T-------------------------------
----------------------------------------------------------------------------------------------------X---T-----------------------------------------------------------------------------------------------
------------------------------X---------------------------------------------------------M------------------------------------------------------|--------------------------------------------------------
------------|---------------------------------------X-------------------E----------------------------------------X--------------------------------------------------------------------------------------
--------------------------------------------------------------------------------------------------------------------------------------------------------------------------------------------------------
------------------------------------------------------------T------------T-----------------------------------?----------------------------T-------------------------------------------------------------
------------M-------------------------------------------------------------|--------------T------------------------------------------------------------------------------------------------?--------o----
----M----------------X-------------------------------B------M-----------------------------------------------|------------------X-------------------------X-----------|---M-------------------------|---v
--------------M-------T-------------------?--------------------X---------------------------------------------?----------------------------------E------------------------------------------------------f
-------------------------------------------------------------X------------------------------?---------------------------o---------------------------------------------------------|--X--o--------------f
----------------------E--------------------------------E--------------------|--------------------------------------------------------------------------------------------------------------------------f
------?-------------|----------------------------T-----------------------------------------------------------------T------?--------------------------------------B-------------------------------------f
---------------------------------------------------------------o---------------------------------?------------------------E------------------------------------------------X?--------------------------f
------------------------------M--------------------|----------------|---------------------------------------------o------------------------------------------------------------------------------------f
m--------------------------------------------------------------------T-----------------------------------------B-o------------------------------o------------------------------------------------------X
XXXXXXXXXXXXXXXXXXXMXXXXXXXXXXXXXXXXXXXXXXXXXXXXXXXXXXXXXXXXXXXXXXXXXX?XXX|XXXXXXXXXXXXXXXXXXXXXXXXXXXXXXXXXXXXXXXXXXXXXXXXXXXXXXXXXXXXXXXXXXXXXXBXXXXXXXXXXXXXXXXMXXXXXXXXXXXXXXXXXXXXXXXXXXXXXXXXXXXXX
