---E------MTBBT-X--o-B----??-E?X-------?EB---?-E--oT---?-EX-M--?o----M----?-MBBE--|-|B--------?--?-o---o--B----o-MM--------MBX----EM---X-----M----o-B-?---?-o---M-----|-----|---TEB-?M?-BX--X?----?-?-X-
-|M-oM-----o-?-|---B-B--T---M-o-E-----|-o--|E-M--T??-?---E-T??M-|---X-|-E--E----EM--MTE-M-?|----M-E-B|X----X----TBEXT-----?-|-T|--E--E--E-T----E--E|E----M-B--|--M-To-T?M-------E--?--|X--?-E?-B?----|--
-E-oX-?----|---|--X-|-----M--X------M---B----T-MM-----?-BXME--------M-?--B-EXX---------?-M------B--oT|E-?--E---|-E---------o-XM-o--o--o--------MB----X-oB---TB---T-E--X---M------|--------M--?-ME--MB---
--ETT----X------T?--|MX-B?-----M-BE?--E|----M--B---ET|E---M---------------E----EB?---X|M--?---o-?--E?---X----|-----E------o-------??--E---TX---To||M---E-|--B--X---M-------T---B|---B--?----T|----X-o---
-B----X-ME-o-o----Mo--E-?----XEME-----M-E----------|E--B-E-X--T-T--------XE-M-B---X----o------oTM-E--E-----MBT-|--??--o|----ET---o-|-T--T-T--B-----o-|---EEo-E?------T-E------X--E-XTo-----MM|-----||---
--?B-B-M----E-E---o---B-X----------B?X--TTo-X---|?Bo--M-?----T----o----B---?-M-X-|---X--------B--M--TT-X------?Xo----M---EoT---E|---oE---X---X--MM|BX?----XT----??E|-BMTB---o?-|M---B----|--E---------|-
--B--o--B--X?---E|T----|B--EE?------oEX--M--E-----XM----T--X--M?--E----o----------X--T--MM--?|-oB------o--oT?--?---B-XEo-o-?-BB--|---?E----MoEB-E-T--o---MX------BT---B-X-M---|B----M|Xo--E------?-o?M--
---o?|EooB-T--X---|---|-M----B-XEB--|T----------T-X---o-X----M-?-T-MMM----?-T------X-?M--B--------B--------TM---XBTXoE-X|M-----|------oM---B-XE?M--EM-o-o---T|BE-o-----?---?E----?--M|------M-B------Xov
---o-M-E-o-M-----To--X---o-----?---B-BXBX?---E-----T-?-o-o--B-B-B-X-----------TM---o-----E------|T-------M---X-----X-----B---BXM---EM-M----T-|?-M----M-B??-?-?----TT|-----XX------|?|o-----EX|-o---?---f
-MM|-|X?----------E?--TB--|X------?---X----o-B?X--?T-oBE------o?|B-M-T?-------E-XM--M-----Bo-E----?M-ET-----T--EEBB-----E-------o-M---XE---oo-|-E------------MMEo--?--B-----o-o---?XM-M---B----?oX---X-f
-----BB---o?---------B--E-B-X--M?--EB-oB-X-------o------B----BE----T|M--------?E--|Bo-------B-M-----BB-X--------?----------TE---|--B?--|----o--??--T-E--T--M--oM--Xo--?To--|-------BM--X|---E---X?-|---f
-o---X--------T-o----o---------o----B---?-----|-----B-----EM---M--T-oT-o---------------|T-M-ME|?-o---?BT-oTEoB?--B--EE---------M--------M------M-EB-?--?--E---------T---To?-o-ET--T--?XB-----E---M--??-f
---|---o-----Bo?|?M----|-B---BE-----M--T---B------------E---oM--oXE?|-TE-----?M------XE--E----B-M--|X-?-M----X--T--B-E?--BT---EE----E--------oB-oX-----------B--B-----T|----M|-o-----T-?---|X-X-?T-EM?|f
--o---X---BM---B-X-B---------X---B-M-B-X-X----?-----B--XE-----?E---T-----M-X--MXX-XT??-|---B--T---?Bo----E---?-E-|M--MEE??---|--BT-----|--E-B-Mo------E?-oM--|-o--M---o-------B--T-XX----ET---TM|---T--f
m---o----T--T-o---M-o------o---|EB-ETM-o--X--X-----M-------------?---E--------X---|-T-X--oM--E--?---o-|-M-XB---X|o----MTM-BE--XT||?---?--?o--E--oE-X--T|-T--T--oX?X-BBo---------X----E?--TXM-X---X----TX
XXXBXXXXXXXXXXXXXXXXXXXXXXXXXXXXXXXXXXXXXXXXXXXXXXXXXXXXXXXXXXXXXXXXXXXXX?XXXXXXXXXXXXXXXXXXXXXXXXXXXXXXXXXMXXXXXXXXXXXXXXXXXXXXXXXXXXXXXXXXXXXXXXXXXXXXXXXXXXXXXXXEXXXXXXXMXXXXXXXXMXXXXXXXXXXXXXXXXX-X
