-B--------B-M--------E------M----?-o-----Mo----------B---B--X---------TX----T---------M---?-o-o---X-E-M-------|o--E-----M---MM-----|-----------X----X----------B-B----M-o-|----o---B---XE------?----EMB-
----------E---o---B----o--o---M------------B---|----BE---o--X----M-----B----------B---M-?----E--B---o-o----T-----|---X-X-X------E-?----BXT-?E-B----B-----MMo--o--------------oM|--M-|---|---M---o|M-----
-E-E-----E---------------TT---?----M----T?----|BE----X--MX--E-----|EM---B----------------------oE-----T---X?--|--EM-o---MXT---?---o-B-------?B---|-XX---E--M-B--o---|------oBE----T--X---E--o------B-oX-
--?-|-XB----?-|--oX--|-E-------?-|-----?--------T-E----E-X-------X----|E|-----|-----------o--?----?o---o-M-X----|------M-----T-------M--o---E-------TEo-|-??M------?----------------|-----|-----o-------
------E--BToT---T-|---?--?T--------oB----------E-------MM---?-B||B-------E-M----BE|---------------------B|--E-Eo-X--|---T-----------o-T---M-----E------T-----|--T---M---o-M-------B------M---M-------B--
----o----o----M----------------MX---------|?-----X|-----oB--X?---M-------ET-M------T---M---------E----T----|o--X--?E||B-ET---|--B----oo---X--M?---?oo--E--------o-------------T-o------?X--X-------B-?T-
-----E-----|-E------o-TE---|-Bo---M---E----?M---E-----oB--o----B-----|E---X--E-------X-----|------T-?-----|-B----?T----------E-----XE---E----BM-----X-T------?-----oM-M----o?-|---?------B-E-o-?-|------
------XM?-E--------E-M---M---o--E-E----Xo------o----T--B-|E---X---TE-B-----------------TB-----T------BBM---o---o?T--o---B---X-----M------M------T?|---o--B---|----X-M---Eo-E--|-B-?--M---|---|--B-----Mv
---ET-------------o-M----X-B--------------o--E--M--------oB---T-------X--E--T----B---BE--X----E?---?-----------T|--X-------?--E----E-E--M---XoB-X-------M-----?-X-------B--o|---|B-M-------o-o-T----T--f
--|--X-MB-M-M--o-M-BBM----E--B--?---o-|--?---X-MM----T-B--|-o---XB----o-ToE-----TB---|--?---E------------T-X-M|---E---X-------?-M----o-B-B------Eo-----|-----Bo----------B-----B-----E|---------E|-T---f
--|---ME-?---T-|---------X---oT------|-------B--------|B--?-M--XMo-X---BM---|-|-----?----?----X----------?B-XXB---------X-T----------?--o--B-----X------------------?-?-----M-----|E|--T-----T--oM-B---f
-?--T-|--|------B-|E-----------E---E--B--------------M--MT|-B---o-ET-|----o----M---?---X---X|-?---|-|T---?----B------Bo------B-E?-?-E---X------oT|E---o-----BM-BX---M--|X--?---------?M-----|---B-B--M?f
----------To----------MM---?-E--------|---------E?------TM------E------B|M-M--------------X--?B-------X-----T--M--------o-B--|-?--T---B------B|-BX-?-------X-B--Xo------|-----X---o-T-?-|--T-?-X--|-o-|f
------|-X-------M--------X-------E------|-------M-o--M--X--o-----X-o------T??o-----|o-------M-----EB-o-|--|o---------M---|-BM----||------------M----?-|?----?---?----B-----Mo---o|-------------------?-f
m---M?--EM-----TTM---|----TB--?-------|-BBo------------o---o-----?---|?-------TE-X-?--X|?----E----------M------o-|------|B-X--?-??--TT-X----M-o--E?----Eo--|---------?--?B-|---||--------?--------B----X
XXXXXXXTXXX-XXEXXXXXX?XXXXXXXXXXXXXXXXXXXXXXXXXXTXXXXXXXXXXXXE?XXXXXXXXXoXXXX|XXXXBXXXXXXXBXXXXXXXXXXXXXXXXXXXXXXXXXXXXXXXXXXXXXXXXXXXXXXXXXXXXXXXXXXXXXXXXXXXXXXXXXXXXXXXXXXXXXXXXXXXXX?XXXXXXXXXXXXXXX
