--T-M------o|------M-B---|M--------E-------M----------------M--------XBE?-BB-E-----X-X--T-----T--E-----o-?-o-|E-------T----oo----------X-------X--------o|-------B--?---|---E----------T-------|-X---T--
-----|---M|-----?--X------?-T-----E------------------B---------o--?--------M---------o-E---ME-------|o----T|-----|--M--T--------|------o-o--Boo--M-T-------------------B-M-M-B-----T------B-T-E---E-----
-X-E----M------?-B-----------B-------------?--------T?-------B|X-E--B----B-B--B--?----E-----|--X----T-B?-|-------T--?-?---------E----TX----|-X---------MB-E----------?-B------T-B---B-----oE-----|--E---
--MB--o-----X?--M-----|--|B---o-------Xo--To-|----?T-----T-E--------E-------T---B-BX----------|--M---T----TXEE|E--|-TB---E-B--T----|M--------?-----------------M-T--T-M-XX---T---B---M-------------|-TE-
---XBT-B-oM-------o-T--B-M--ME---B---o--T-M|-----X-|----?-E---------E-TT------T--?------------M-------E---?M---X-----E---B-E----------B----X-M---M--XM-E---T---M---TX--XT-E-|----T-----------E-------M--
-X----------X---M---E-M-o-------E--|----------X-X------o---E-------BM-----?|-----X-o----|-B-o---X--?-E---------M----X--M-----------------------B--o--------------------------|-------E-o|?T-------------
-E---------EE-X--oME---B--|---------------X---X--TT--E----M----?T------X----?----------X-M------B-T--?-------|BB--------B-----------M---|-----TT------T---B---X-o-----?--?-------------------------?E-|-
-o---T-----M--X---M---E-----B?-T-E-oE---?--T----------B------------------------M----T---T-------|-|-------------o-M--E-M------T-----BT----------o--B------?X----|--B---X----o-----E-?-M--|--X---Xo-----v
-X------X|B---E---------MX---|--T-----------------T----------E--B-------------|----------o-MM-----M-T-----E-?M----E-?M---B-X-?---B--E-?----o-------|----E------------X-----B?--E|--B-----T---M------E--f
---------T----X--M--Boo----------|----------|-?-B-T-M-------o----T--E---------E---T--MX-----T----M----TT--------T--BX-------E-------E-E----------|----M-E----X--------M---B--o-------E----E-B--M----B--f
----E---------B----M----|------E------------o----------------M--B----------ME-----XM|--B-E-X?--?--?-|--|-------|-------T-----oo----------------?----T-o----o-M--o----T----X-B------------B-------B-----f
---X-------E----------o-?|-M--?--?----T-X---E-----------------?T-----X--M---M--E?-TM-------------E--oX---T--------o----|-X-?M-------X------?----||-----------------T--E--?--|--M--?----?-?-X-?----o|---f
--------M--------------E--B--TX------E---------?----BE----B-------o---|---M--------EE--T---------T-X-B----B----T--TB--T--M---E|--X---M-------?X-----o---E------------B-----o-XE--E-----X------------o--f
-B--?------T----------------|-----E--X------o---XEM---------|-----M?-----------?o---o-------------T-X----X------T?X-X--BE--|---B---B--o--------B--|----M---o-----o?-----B-TB-----B---------E-B-X-----E-f
mB----X-o-------ET-----M----------TM-?--M------M?----T-----o------B----?-|-------X--T-M-T?-------o--M-o----M----o?------------------o----o----------------|------------XE-----------B----EB?--BT--X-Mo-X
XXXXXXXXXXXXXXXXXXXXXXXXXXXXXXXXXXXXXXXXXXXXXXXXXXXXXXXXXXXXXXXXXXXXXXXXXXXXXXXXXXXXXXXXXXXXXXXXXXXXXXXXXXXXXXXXXXXXXXXXXXXXXXXXXXXXXXXXXXXXXXXXXXXXXXXXXXXXXXXXXXXXXXX?XXXXXXXXXXXXXXXXXXXXXXXXXXXXXXXX
