---|XE--oEEB--T-MoT-X?--ooE-?B-EM?M--E-B|-B-XET-B-T-E|-T--XX--o-B----X-----XBB----E--o-B--TM-T-?X-XB--o---|--|-??M-MEE-?-------M-oMM-oE--oEo?-BooT---?----TEXT?|-EME|--EXX--o--TTB-E-?E--?B-TTEXo-B---M-
---X-MT-o|?T?----X|-?--EE--?-E-MT---T--|E---|----?-?X-E---------|------Bo?----E----XoE-BoM-X|--B-B||XB-|MBT---?-B--XT-o|E-----?TB--o---X---M-oo-E--M--Eo-E---|?To--X--XX-E|-E-----E-|?X-Eo--M-?----XB||-
-|T-?M-EXXX-E------X----|--o-----|MTM---o|---T?--BT-B-M-B----oE-o---o-?X-XMX-EM--B|o-?--?oTX-----?M|B-oo-|E-XT?--BMT--MMM-----E---?TMB---?----MX-X?-E-----?B--B-X----M-o?-XX|--TT?o|BE|o-B-BXXBoEoB--ME-
--|B-B-o-M--?-MT--TX-T|--MT--B|XEETX-X-?-METT---T-XT-?-X-T-XB-o-?o---oT---B-X-----X-oT-EM-B-------|--M|-?---ooE|M--o----MEX---EXX-T|o----BoETXB--o-?----TE--?-X-MMX-XM-E-M|?BoM--T--TXoo-Eo--M-oM-----|-
----|-To--o---|E-Xo----?M?-M?X--o---T--?ETE-?X-MooTT---ET?-M--MM?-X-TT-------|X--X--TB-E-----T|----M--M-MMBo---ET--B-|T-oXX----M-E--EB-|BM--B----o?X-MT-B-o-TooE-MX-T|o-E--Mo|--TM|o?-BE-T-M|-XB--o-X-?-
-T-----MT-o--T-E-ET?oM--M--M--|ME--?-TXXXo?--BX----o---XT|BE-TBB|-E-T-M?-MTE-XX-EMo--oE--ET-|--B---MX?B--BEET|oTB---o-|T-|T---|--To-MXTEB-XX-B?-T--|-T---?T-?-X--|X---EM?-M-|T--E?---BTX--TMX-B-|-M--B--
-BoE-Eo---------X|M-o--B-T--?---ET|-oE-E-MoT---|M----B--TX------------|BM---o--|E-B?Bo?----M----?-B---|T-MoTB-X-------E-----o-T----B----|B--oT-X-?---|M-?--?-|M|B---|-EM|X|---|-?--X--?--X-B--o---T|----
-B-o|E------?E-X------B----?X-|o--|T-EM?-?|B-o-Mo-o-o-|X-X?B|T----?E?-XT-?EBXB?--M-E-XT|-B-E?X---o-|X?-X----EX|ET-T--E--X--E-Mo-B-M|oE--B-T--B--?--o-MM-BB-?oT-|----|B---X---|-M?---E--XT--X--?--Xo?-|?v
-TM--E--EX--|-M-X--MT--M-------BE---|E|----BE-?-------B|-?BB---E-|---Mo--X--B-----?--------|--?TEE-E-------B--MB-E?|-B|-oXM--|-----B--T----M??--M----XX-XE|X-?-BT---B--T|---?--M-o-MB-X--M----BXB-T---of
--XT--E-X?-X-o--|--XX-|-|---XM---?|-MM|ooo-XXEX--o-|--EXoEET--T?--M-?-M-?-E-EE------|-?E-BT--?-?--M---T--T-|M-----|---T-B---T----?MMX---EXE---E---|T-|E?MM----??--BBXE-Xo|-----E?----oB--|-E-?-?--B--BTf
--XM------E--o?----ET?M||XT-----T--E-?M--|-T-o-?--?BoB---ME-T-M-|?E---M--|-EXX?-TT--M--o---X--o?---B-?TMXo-M--B|?E-TEM-MB-|-?-?MB------oX--oM--o?--E-o-??--T--M-X?XXT-?-E--?-Bo--EB----|?-EE-?M-X-B---|f
--M-----XXE-----o-T||----T-o--B---E---XX-Bo--?B|-o|T--oX----------?--o-o?o--TT-o--B|-oB-M--??-ooB|-?|-Mo---?--?BoT--B---o-o-?T-?--M-----X-XB-o--MXE---|--B-B-o----T---|--T--M-MBo?--T--TE--o-o|o-----T|f
--?E-T--oB-X-|E---?-Bo-o-----Xo--|T-B--X-o-BE-----B|---o-|------B?---M-T--M--ET----o---M-o--T-|M-ToB|M---E-B-TB-M-|||--|E---T-------|---X-XToM?MT-X-oT--------M-?--M-oE-T--|---M--B------TB-?MT-----EXMf
--|T--|-----ToEM-T--?BE-E-----BoBB-o---MXM-||----ETB--XX----X---o-o?---T-Mo-EEEE--|TEE-?-M-E----|B-X?E|--M-oT|M-o-?-oTE|-X-----T-|-?-T-X-BME-T-?|-M--?---M-E--oTToEoT--T-----o---------?----|-o-ME-M-?-f
mE--MX---TE|--E------XT---|---|o--B--EE---o-XE---XM--T-X-Mo-MB-Xo-|-BXX------T-o-?----EB-M-?X---E----o-o|-----X-Xo---TM-T-|---B-o--M??------------T-|--B----E|--?--T---|-B-B|--EE--|MBo-----T??MX--X-oMX
XXXXXXXXXXXXXXXXXXXXXXXXXXXXXXXXXXXXXXXXXXXXXXXXXXXXXXXXXXXXXXXXXXXXXXXXXXXXXXXXXXXXXXXXXXXXXXXXXXXXXXXXXXXX-XXXXXXXXXXXXXXXXXXXXXXXXXXXXXXXXXXXXXXXXXXXXXXXXXXXXXXXXXXXXXXXXXXXXXXXXXXXXXXXXXXXXXXXXXXX
