----------------------------------------------------------------------------------------------------------------------------------------------XXXX------------------------------------------------------
--------------------------------------------------------------------------------------------------------------------------------------------------------------------------------------------------------
-----------------------------------------------------------X-M-------------------------------------------------o----------------------------------------------------------------------------------------
--------------------------------------------------------------------------------------------------------------------------------------------------------------------------------------------------------
---------------------??---X--------------------------------------------?---oo-----------------------------------------------------------------------------X---------------------------------------------
-------------------B-----XX-----------------------------------------------------------------------------------------------------------------------------------------------------------------------------
------------------------XXX----------------------------------------------------------------------------------------------------X--------------------T--------------------X--------T---------------------
-----------------------XXXX-------------------------------------------------------o-----------------------------------------------------------------|----------?--------XX--------|--------------------v
----------------------XXXXX-------------------------------------------------------------------------------------------------------------------------|------------------XXX--------|------?-------------f
---------------------XXXXXX-----------------------------------------------------X-------------------------------------------------B-------------B---|-------T---------XXXX--------|--------------------f
--------------------XXXXXXX-------------------------------------------------------------X----------------------------------------------------------T|-------|--------XXXXX--------|---T----------------f
-------------------XXXXXXXX------------------------------------------------------------------------------------?-------------T------------T--------||-------|---XXX-XXXXXX--------|X--|---------------?f
------------------XXXXXXXXX-------------------M--------------T---------------------------------------------------------------|------------|-?------||-------|------XXXXXXX--------|XX-|----------------f
-----------------XXXXXXXXXX---------------------M------------|---------------X------------X----------------------------------|------------|--------||-------|-----XXXXXXXX---XXXXX|XXX|----------------f
m---------------XXXXXXXXXXX----------------------------------|----E---X-------------------XX---------------------------------|------------|--------||-------|----XXXXXXXXX--------|XXX|----------------X
XXXXXXXXXXXXXXXXXXXXXXXXXXXXXXX-------XXXXXXXXXXXXXXXXXXXXXXX|XXXXXXXXXXXXXXXXXXXXXXXXX---XXXXXXXXXXXXXXXXX-----XXXXXXXXXXXXX|XXXXXXXXXXXX|XXXXXXXX||XXXXXX-|---XXXXXXXXXXXXXXXXXX|XXX|XXXXXXXXXXXXXXXXX
