-B------o?B-M---|------------B--------------|o--------------X--B-------M---ETE-------EM-T--B-----B-ME---------ooB-------M------E-X--B--X-E----M-----X--------?-B------M-o-M-E--o---B|--X--E--E-?----E-B-
----------E-EXo--EB----o--o----------?-o--?--o-|B---oE----M--B---M-E------------------M---------B--?-------T---------X-X----------?----B-T-?--B----------M-o--oMX-------?---EoM|M---|---|------?o-------
--------------T------o--ET------T-------T?----T-E----X---X--E-----|-MB------------------------------------X?-T|---M----E--T?--??----B-T-?---?--------------M?------------------------X--EEM--o-o--oB-oX-
-------B---------oX----E?-B--|-?-|-?---?---B----T-E?-o-------o----E--o|E|-------|-------B-o--?---------o-------E|------M-----o-B--X--M----MB---M----TB--|-?-M-----X---------E----B--|?o---------oo----M-
-----B|?-BT---X-T-----?---T---------BXX--------|------------?-B|---------E-M--T--E----M----------------EB|----Eo-X--|?--M-----------o-T--X--E---E|----?T-----|--T--T-----?M---?---B--M---------------BT-
--E------o----M-----------T----M---------M|-----E-|-----oB--X----B----E--ET--------T?-----B-o---|E----M--E-|o|B----E----ET---|--B-|--Xo-----M--E--?--E----|-----------------E----------?---XE-B-E----?--
-------XE--------------?-T--XB---|--------E-----E----BoB---o---BX---||E-------E--T--?X---------------------------------B--o-?X-----X----E-------------T------------o--M----o?-----?------B-E---?-|-T----
------XM?XEE-------EM-------Mo------B--X-------oX------XX|----X---T--B-----M-T----------B---X-oo----T---M-To-|-o?--X---X----X-------?-oo----B--o----E-E--B--------X-M---E---M-|??---M----|---|--B------v
---E---?---------------X---B------------X--------?-T---o--B---T--X----X--EM----------BE-T-----E-|--------------T-------?--M--------E|E------|--?X-------M---o---X-M-T------oT---|--M-----E--Mo-T----T--f
--|EEX?--X-XM--o--T-B----|E-----?--M---B------T---oT--T---|------B---?o----------B--?---?---------?------T-----TX-E-----------?-Mo?--o-B-BT-------T----|------oM---------B-----B--B---------MM--E-----?f
-----------------|-?-T-oo----o-o------E-----TB------------?-M-o--oXX---BM-oT|----|--T|-X------X-oM--|----?B-XXBT-B---------------------|---B-----X--?----o-------BX---------M-----|-|-|T-B---T--oM-B-oTf
-?----|--|---------E-E-----T------X---B-------------?----------|o----|o--------Mo------X----------------M--X--B-------o?-----B--?-?o-------B------E---o---|-oM------M--B---?---?-|E|--M---------B----M?f
--M------|--?------X--MM---?----------------B---E?B-----T-----?-?--E-----M--o---------------M?--B---ET-E---?T---T-------o-B---M-------B--o---B--BX-?-------X-B--Xo------------X-?----------T-?-X----|-|f
-T---E----------M----E-X-X---M-----------To------?---M--XT-o-T--------------?-------o--?--TX------------M-|-B--------M---|--M--XT|----M--?-----M--|---|?---------E---B--M--M-B---B---------o-M-------?-f
m----?--E------TT----|--?-------------|-BMo----------------o---B---------------E-X----X--X------B-B----MT-----------o-----XX----??E----X----M-----?-----o-?|o-?------?M-EB-|-T-----------?E---X--|-EX--X
XXXXXXXTXXX-XXXXXXXXXXXXXXXXXXXXXXXXXXXXXXXXXXXXXXXXXXXXXXXXXXXXXXXXXXXXoXX-XXXXXoXXXXMXXXXXXXXXXXXXXXXXXXXXXXXXXXXXXXXXXXXXXXXXXXXXXXXXXXXXXXXXXXXXXXXXXXXXXXXXXXXXXXXEXXXXXXXXXXXXXXXXXXXXXXXXXX?XXXXX
