--------------------------------------------------------------------------------------------------------------------------------------------------------------------------------------------------------
--------------------------------------------------------------------------------------------------------------------------------------------------------------------------------------------------------
------------------------------------------------------------------------------------------------------------------------------------------------------o-------------------------------------------------
--------------------------------------------------------------------------------------------------------------------------------------------------------------------------------------------------------
----------------------------------------------------------------------------BBB-------------------------------------------------------------------------------------------------------------------------
-----------------------------------------------------------------------o----------------------------------X---------------------------------------------------------------------------------------------
---------------------------------------------------------------------------------------------------------XX??????-------o-------------------------------------------------------------------------------
--------------------------------------------------------------------------------------?-----------------XXX-----------------------------------------------------------------------B--------------------v
--------------------------------X----------------------------------------------X-----------------------XXXX--------------------------------BBBBB-------------------------------------------------------f
------------------------------------------------------------------------------XX----------------------XXXXX-------------------------------------------------------------------------T------------------f
--B--------------------------------------------------------------------------XXX---------------------XXXXXX-------------------------------------------------------------------------|----------o-------f
---X--------------------------------------------X---------------------------XXXX--------------------XXXXXXX-------------------------T-----------------------------------------------|------------------f
---------------------------------------------------------------------------XXXXX-------------------XXXXXXXX-------------------------|-------------------------------------------T---|------------------f
----------?--------------------------------------M------------------------XXXXXX------------------XXXXXXXXX-------------T-----------|-----o-------------------------------------|--?|-----------------Tf
m--------------------------------E---------------------------------X-----XXXXXXX-----------------XXXXXXXXXX-E-E---E-----|---------E-|---------------------------------X--------o|--E|-----------------|X
XXXXXXXXXXXXX-------XXXXXXXXXXXXXXXXXXXXXXXXXXXXX-----XXXXXXXXXXXXXXXXXXXXXXXXXXXXXXXXXXXXXXX---XXXXXXXXXXXXXXXXXXXXXXXX|XXXXXXXXXXX|XXXXXXXXXXXXXX-XXXXXXXXXXXXXXXXXXXXXXXXXXXX|XXX|XXXXXXXXXXXXXXoXX|X
