-B---E---?B-M--T--------T----BE----o---T--o--o---|--E-------X---o-X---TM---E-----------o---Bo?--TB-M--Mo-------o--E-----M----M-E-------E------MX---------X-----B------M-o---E------B------E--E-?------B-
----------E---o---B----o--o----------?-o--?--oB---?-B-----M--B------E-----------------M----EXEB-----E------T---------X-X-o----------E?-B-T-?E--------E-M-MMo--o---------?-o--oM----------X?-----ooM-----
-E-------------------o--ETT--o--T||M-----T---?T-E----XT--X---X--M--E-B--B--o----------------o---------T---X?--|?--------------?----|Bo---E--?B---|------E--M?--X------------oE--B---------M----o-Bo-To--
-------B--M-----?oX--|-E-------?---?---?-|-B------E-----EX---o---X---o|E|-------|---------o--?----?----o|-------|--T-TTM--------T----M--oo-BT-X-----T-------M---------------------X-|-o--o|-----|o------
-?B-T--?----TE--T-----?------------oBXX---T----|------E-----?-B||--------E-M-----E|o--?----------------EB|----Eo|X------------------o-T--X-T-X--E------T-|---------T----o-M--X?---B-----BM---M--T----B--
---T-----o----M-------?-------BM---------M|?--E-E-|---o-----X-------E----ET-MT---X-B-EM---------|Eo---M----|o--X--?E||-------|T---|--o------|M?o--?--E-E--|-------------|---E--T-MT----?X--XE---E---o---
--?-?--X-------|------T------Bo--|---M-B----M---E------B-------B-E-M-|E------E---T-T?|--B?o--------------||--------T---B--o--X-----X----E--M-------XX-----?X-?---T-o----E---?------|-----B-E-o-?-|------
------X-?-E-----Mo-EM--------o-----o----B------oX---T--BX-----Xo-----o---?-------E-X----B---X-------------To-|-o?T-Xo---B-----o-M-M------M-M-X-o----E-E--B---|----X-M---E-----|?---------|--?|-M--X----v
---ET-??-|--?-o-----M|------------------------M-E------o------T------BX--EM-T--------BE--X----E?-E--X----------T|--X------M---B----E-E--M?--|-----------M-------X---T---B-?o---E|--M?X-----o-o-T-----M-f
--|E-X?--------o-M--B-----EB----?-----|--?---X----oM-----||------BM--?---o-------oE----??---------?-----X----M-T----?---------?-M--o---B-BTo------T-------|---oM---------BX----B------|-----M------T---f
---E---------TB|-|-----oTX---o-------|--------------------?-M--XMoX?E---M--T---T-|----MXM---|-XX---M------B--XBT-B---?--X--------------|---B-B---X-------------------------B------|-|------------M-B-oTf
-?--T----|---------E------------------B------E----BX?---MT--B|--o------------E-o-----------X--?--B---T-----X--B--o----o-E-------?--oE-----------------o---|-B-??X-T-M?-----?X-o?-|E--------T----B-B--M?f
---|-E----T-?---o--X-M-M-----E-X--X--B---------?-?------T----------E-----M------------------M?B-------X----?T-----o-------B----?--T---B------B---X-?-------X-B--Xo------------XE----T-?--------X-------f
-T--o----o--|--|M----E-T-X-------E-------ToB-T---?---M-------T----B---------?------|---?---XT-----E-----M--M--o------M---|--M-----|--o-o-------M--|---|?EE------?E--?------M?---oB---M-----o-M----B--?-f
m----?----o----TT----|--?--------M----|-BBo-|-----o------------E-?----?------ETE-X-?--------X----------BM--?-----|-----o-BXX--B-??--------M-M-o---?------|?|----------M----|-T--|--|T?-B-?E---X---B----X
XXXXXXXXXXXXXXEXXXXXXXXXXXXXXXXXXXXXXXXXXXXXXXXXXXXXXXXXXXXXXXXXXXXXXXXXXXXXoXXBXXBXXXXXMXXXXXXXXXXXXXXXXoXXXXXXXXXXXXXXXXXXXXXX?XXXXXXXXXXXXXXXXXXXXXXXXXXXXXXXXXXXXXXXXXXXXXXXXXXXXXXXXXXXXXXXXXXXXXXX
