E--E|-E---T--E-M---E----M---?--EoooX-o-BEE------T-----o--M-XT---?---|--Mo--EE--M----T|-o-|EX--MM?E-BXToTXM---o--XB-B-X-MMEE-o-XBB|?--BE-X------M--oM-----?BE--oE-Mo-T-T------|EMM-----B?X------BX--B-XBE
--M-MMXMB|o----BE--M--E-?-T--EB--M-?o-E--oXE--|----|--TE--|----ME-BE---?-BBoX-M-T-EooT-M?-----|------------o-|-?o|-XXMo---BXEo-----?M---?B-?o--?-?-M--M-----o-X-o---B-o-B--o-MT--M|--?Too?oo---o---X-|-E
|EXX|M-EE|?|o---o-----M-E?o-E-T?-o-----E-|BM-----B-|?--Eo---E------?--?--o----E-T-E-M-X--X-T?T-||-?--M---T--TEEE--T--?TT----|B-T--B|E----BM----E?-E-EE|-B|-T-T---o-----X??T--X|-T---TB-E-MMEE-TE-T--MM-|
ET-----T----ME-??-TX?Xo---M--E-T----MBTT---E?TM---o-?---o--?BB|--T---?-X||B-|||-B-XoX?M-|E|--BE--|-M--B-EEB-----XMo|o--X---ooE--------?E-EB-X-o-XoMo--Mo---||-|ToTX---?M--XX?EM-|--X?-oXTB-o|?-o----XBM?
T-B--X----------BX-|--B-oMM-?--T-M------Bo?-T----o---|?-MoB--?------oM-E----T---oX----X---??-XMB---MM---?----o?-M---E|-EX-B-TMo|X-------TXBB---M--E?-----TXBM-X--EMT--BE--?X-MXM----TM-Xo||-?o-o-E-T--?T
XBX----M-?-X--|-----?--??EEX--Eo?------E--oo-?-o--E-M---TXBo|-----?T--B-----oo?--EEo--ET?-ME-M-?--?----T||------X?---------M--M------M----X-??--M---XB----MX--|----?EXB|M|o-|--B------|T------E?-----o-B
?--XMB-ME----B--E?BB--B---??-X-oB---?--X------T--?T---?X---o-M---?--?------?Xo---?E--|----|-X-||-M-----T-X----T-BX--X-XTX|--o---M---M--|-?-E?--T-----|-----T---X?B--oMM--|-oX---XT-M|---X|--?|---|---X|o
?-----?B------?M-XX----M-E--|MT--B------?------EB---X-?-E|?-|-MoM-X-|--MET--TX?------MMT-|--o--B-oo--MMoX-------BoTE-T--?--|?X----B-E?-?------T--E-------?XB-o?--M---|M-B-|-|-----?-TTX-----||B-E----oEv
E--MB---T----XTM-Eo-o-E-?X-X-TT||B----oEE-B--M-M-X-XEE-TM-EooX|E-B-X--EXTXT?E-Mo---XEB-X-?X-EX---M-B--E-M--X-MB?---?o-|E|-T--XT?--B-T---MXM-M--|----?X-MoE-BXo-----XM|--X---E|--B-T-B||XX---M-BBMMMo-BE-
?MB-B|BE-o-T-?Eo|-?--X---ooXo---X-M-BT?-T-|E|-B-?M|T-----X-E-M---o-E--MBB-o?T--??-------|--X-MB|-M---|X-Eo--|--o?---Bo-BB--T---M--B--TE--?o-----M-X--|E-?X?X?B|TB--M|--X---X-oo-X---T---To-|M-X-oE---ET?
M-E|--E|B-------------?|--ooM|?-BB-MT-----|E--o-X-B-|T-X---?-----o-----T---|--MB|MMB|-MB-?-BMoo-T--o?X-E-B----|?-E--B---E--M-M--B-M----X-??-Eo-o-Eo---M---o----E-?-T---X-MBoMXB--E--------|---XX-B-o--MM
----M----oE-|--B---MB-E-BE-MBT??----M----?-T?-E?M-M-o-X-B----|-T-TX--E----ETX?oE--XT-E---oXo--M-T---ToXT-?----X--XBB----XBM-B-E----|M---|-|-?-XB-T--B-oX-|o--BB-oBB|--|-oB----X--|--E-MTX-XX-o|--To-|E-M
?------T--T-T-?MEM-||--?|--X---|T-XEoo--T-T---MM--B--E-oT-oT-E?|-X---B|--oMXT?-M-oX-TX----T|?---B--X-M---TT?---X|T?-----?B?MT----Eo-oX--T|M---|--MBT|||o-|---?o--o|-BoB--o-B?-|-T-----?--EM---|MB-----oX
oT--X--?----BEME-M--M-B--?---||-E--X-T|Xo|---------?B-o----|oXM----|---?|--B-BE-------------oBM--|B-B-----BE|TME-E-B----T-oTB--ET-X-XXMX-BXETE---T--M-T-MEB--X--M--o-o?---E---EE--T??T-------?--Xo---oo|
m-X-To|-EMB--?--B-X--T?-?-----B-X--B-B----M---|X-T-E--E--o|--T-E-T?E--T----T-M-E-M-E---T-?E--X--M-oo-X|-o?-------?--X--------X--MX?XMBXB-?-?X---M?E-T--X-E-|--M--BEB-XE-o?--M|?-?XXEo-oXE-T-T-TT-B--X--X
XXXXXXXXXXXXXXXXXXXXXXXoXXXXXXXXXXXXXXXXXXXXXXXXXXXXXXXXXXXXXXXXXXXXXXXXXXXXXXXXXXXXXXXXXXXXXXXXXXXXXXXXXXXXXXXXXXXXXXXXXXXXXXXXXXXXXXXXXXXXXXXXXXXXXXXXXXXXXXXXXXXXXXXXXXXXXXXXXXXXXXEXXXXXXXXXXXXXXXXX
