------E-?-------------------------------?------------oo------M---------E---?----------?--------------B----------------------E--B--M-------X-?B-----o----X------------B----------B-----o-----??X--M------
-?------------------------------E---M-----?-----E-----E----M-------------o------o---------------------XX----------?---E---?----------------------M---X---M--------------------------------M-----E-------
---------------------oX-----------T---------M-X------------?--?------E-M--B----B--M-----M-E-------X------X-T-----E---X------E------------------------E-?--------------------o-----------------E----oM---
---M-----B-X--M-----E-------------M--------B------------------BX--------o------------------------?-o-------B------------------X?---Mo------M-X---??T---------B--------------E-----------?--------E----o-
----o-o--Eo----------------------------X---M--M----------?-------X--B------------M-------X--o----?--ME------------X?---BEX-B--------------M----M--------------o-----------------M-o----B-----------B----
-----E-E------------?-----BT------B-----------M------------------X-------M--B------o-----------------X-----X---------------?----o--?--------?--------o-------------T-M--------X----o--------------------
----X------------------E---X---------o----B------o----o-----X-E---oE----B-E------M-----?--------------X---M-----?B-----o--------------------------M--?---X----X---X?------?------------T---B------------
-?-------------------?-------X--------------oX---------------------B-T-----B------------E-------T----X-?-?---------M----M-------------E-----B--o----------M-------o---M--?-B------B----X?-----B--------v
--X-M---------------------o------?M--?--BX---------ME--o------------oX---M---------------------TB------------X------------M-----------?---?---o---MX--------X--------M-M---M------M----B---------------f
------X---------M-----MB----------E-------------oM----------------------?-----------------M----X-?------------------X----E-B--T----X------E--?---o----oE---------X--o---------B?-----E-B-------X-------f
---?------o---------E------------MEMB--B--------------MB---EX--X--------------o--X----------?--o------------o----?--?-M---o---?--E-------------------------------MB-----------E---------oM----------E--f
------------?---------o-------------T-------------o--?-------------X--oT------B-X----------o--?------------------------o------?M------X--E---B---------M---E?----------------X-----------X-------T-----f
-------------------?-----------M--o-|---?------X-------------------B---B----------------B---------?----------B---------?--------------------------------T--B?-T-oX------------E--------------X---|E----f
------E---o----?--M--M-------E?--E--M------------------------------T----------------o----------------------------X-----?----------B------EB-XX----------X---X-?----B------M--o---X?-------o-----X?-----f
m-T--------------------T------T-----E------E-----T-----------------|------------T-------------------------B-B----M-------E---E--?----------T-----------T-----?--?---E----T----T----T--MT---------T-----X
XXXXXXXXXXXXXXXXXXXXXXXXXXXXXXXXXXXXXXXXXXXXXXXXXXXXXXXXXXXXXXXXXXXXXXXXXXXXXXXXXXXXXXXXXXXXXXXXXXXXXXXXXXXXXXXXXXXXXXXXXXX-XXXXXXXXXXXXXXXXXXXXXXXXXXXXXXXXXXX-XXXXXXXXXXXXXXXXXXXXXXXXXXXXXXXXXXXXXXXX
