-MXMooTo?oT?oXEEM|?BBToTo?T?EBEMBXoX-|oTM??ET|-XEBB-MoE--|?|BEM-XMXETE-M??|oooX-B|oB-XMXBXTXM-Bo|-EEEEXB|?BXBXo-M|M|?BoT-MT|T|XE??|MMXXXoMXEooE-o|MoBMToBXTo?MBB?-EMB?|XoE-X-XMMTE||-|MBXTX?|oBX-oB|EBEM
oBM??|||Bo|-E-B|-|Eo||M||||MBTo-E|o-?|M|ETTo||T|-Boo|X|o||||||B|Mo|-|M|||M|B|||B||T|||BMM||T||TE|X?X-MM?|E||MEEo||o||X|||E|||||BM-|M|EX|TBMBBTT-||B?Bo|oB||TX|?|-?oBM||EXB|||o||||||B|?EM|TE|||-TTX|B|EB
?E|??|||-||o-T||||T?||?||||||||M||EE||||M|||||||B||B|B||||||||B||-|||-|||M|||||||||||||||||||||-|E-M||||||||X?|X||M||||||E|||||EEE|||B|||XXB||||||||?X||||||||||-||B-||||T||||||||||o|T|B||?||||||B||||B
E|||||||||||B||||||||||||||||||M||||||||||||||||||||||||||||||-||||||T|||||||||||||||||||||||||||||||||||||||||T||X||||||||||||BE||||T|||||M|||||||||o||||||||||||||||||||||||||||||||||o||-||||||E||||?
X|||||||||||M||||||||||||||||||?||||||||||||||||||||||||||||||||||||||||||||||||||||||||||||||||||||||||||||||||||||||||||||||||o||||||||||||||||||||||||||||||||||||||||||||||||||||||||||?|||||||||||B
o||||||||||||||||||||||||||||||||||||||||||||||||||||||||||||||||||||||||||||||||||||||||||||||||||||||||||||||||||||||||||||||||||||||||||||||||||||||||||||||||||||||||||||||||||||||||||||||||||||||X
X||||||||||||||||||||||||||||||||||||||||||||||||||||||||||||||||||||||||||||||||||||||||||||||||||||||||||||||||||||||||||||||||||||||||||||||||||||||||||||||||||||||||||||||||||||||||||||||||||||||E
B||||||||||||||||||||||||||||||||||||||||||||||||||||||||||||||||||||||||||||||||||||||||||||||||||||||||||||||||||||||||||||||||||||||||||||||||||||||||||||||||||||||||||||||||||||||||||||||||||||||v
E||||||||||||||||||||||||||||||||||||||||||||||||||||||||||||||||||||||||||||||||||||||||||||||||||||||||||||||||||||||||||||||||||||||||||||||||||||||||||||||||||||||||||||||||||||||||||||||||||||||T
T||||||||||||||||||||||||||||||||||||||||||||||||||||||||||||||||||||||||||||||||||||||||||||||||||||||||||||||||||||||||||||||||||||||||||||||||||||||||||||||||||||||||||||||||||||||||||||||||||||||X
?||||||||||||||||||||||||||||||||||||||||||||||||||||||||||||||||||||||||||||||||||||||||||||||||||||||||||||||||||||||||||||||||||||||||||||||||||||||||||||||||||||||||||||||||||||||||||||||||||||||E
B||||||||||||||||||||||||||||||||||||||||||||||||||||||||||||||||||||||||||||||||||||||||||||||||||||||||||||||||||||||||||||||||||||||||||||||||||||||||||||||||||||||||||||||||||||||||||||||||||||||-
o||||||||||||||||||||||||||||||||||||||||||||||||||||||||||||||||||||||||||||||||||||||||||||||||||||||||||||||||||||||||||||||||||||||||||||||||||||||||||||||||||||||||||||||||||||||||||||||||||||||?
X||||||||||||||||||||||||||||||||||||||||||||||||||||||||||||||||||||||||||||||||||||||||||||||||||||||||||||||||||||||||||||||||||||||||||||||||||||||||||||||||||||||||||||||||||||||||||||||||||||||?
m||||||||||||||||||||||||||||||||||||||||||||||||||||||||||||||||||||||||||||||||||||||||||||||||||||||||||||||||||||||||||||||||||||||||||||||||||||||||||||||||||||||||||||||||||||||||||||||||||||||M
XXXXXXXXXXXXXXXXXXXXXXXXXXXXXXXXXXXXXXXXXXXXXXXXXXXXXXXXXXXXXXXXXXXXXXXXXXXXXXXXXXXXXXXXXXXXXXXXXXXXXXXXXXXXXXXXXXXXXXXXXXXXXXXXXXXXXXXXXXX-XXXXXXXXXXXXXXXXXXXXXXXXXXXXXXXXXXXXXXXXXXXXX-XXXXXXXXXXXXXX
