TB-------To---|MEE---|B--T--XMT--oE---XT--o-T|M|-E---|--|M----oTMX-E--BMBM---TEo?--E|B-B-BoM-?X--?TB-EB-XEo-?--B---X--|-XT-?---o?----BB-B|--o?-?-X--o-B--||--|--?-MM-X-M?-X------X?-B?-o--?BX--o--BE?-|?
T?--EX|-M?-E-X--------M?--??-|T--E------M-?----MM---TB-E|--o----?o-T--B---EBT--X------E-----?B-XX-?----B---o-?-T-T-X--MX-T--o-M-XoEB----Mo-X----M|?BM--?-M-?o--?|E-|??-o---|---E-?M-B-E|B---MET--E--?M-M
E-?--|-|-EM--oMX-------ET-E---B-T--MM--T---X|B---X|E---T-XM-o-M|X?-X-----o--B-oM|-MX--BMX-ET--|------|-|oTM----T----X|----------?ToTT-M-T---E-X-B--|----o-B--TT----o-o---?X-T|-EEE?Eo-------E-----T---EX
X|X-X-E-?-----T----T-To--|-Bo------M-o-M|-XX--oM--XX-B--ooooX----E--|-ET|-o---XBE--o-M|E-M|BB?--X-|TM|---?---XoE--|?-M-X-T----ET-?BM?X-o?E-oT---Too----B---MEo|--B---oB----?M?--B--|B----|-BE|--?oXB-T-T
-BoX|--|X-B--T-E-Mo----|T--M-XB-|oBoooB|-oM--TMoTXM-?XM--B--E------B-o--M-E-B-Bo--XBTM---o---M?-?------o---T-M-----|oE-|--B-?B---X----|M----|E---EBoM--MT-?MB---|?--------|To-|oX|EB-X-?-M--T--T--T|-Xo?
----B--X|o?---oX-B--|T---------||-----B-MXE---X--o---TT-Xo------E----?-E--Xo-?M-BX--o-B---TXE-MoT----|-?B------T-oB----?-?-E----oM--X--M-----o--X-o---E-B-X--M?----?-T?B-BM??-E|XB---|o---?B|--oE----oEM
?o-E?-X--TET----E------B-M-XB-X-||-M-Bo----T?M------XM--E---?E--o|E-T--E-----?-ET|-----TB-|-|-|E---?B--|X----B---Eo-oEX-EB-?---|----------M---BE-To--oT-M----MMT---?-MXEM----M-E-EMoB--B---o--------|o-|
M-X-E--T-|-MB?|-?B-Too-T----BX-E-|-?--|M-T|---T----B----X--MoT--oME|--M?-----XEX?-EX-?---XB--T-----|-?-TEX-----T---------|X---ET--?--|o--||--B---M--TB---To--Xo--XX--T|o-Bo--oE?MT-?M?----B--X---B-M-BBv
|------E-E-TBoM--X---XEo-|--X||X-EM|-o--X--X|---TM-|BEETE?T|E----oB|B-oo-?--EBE-XE--o?-TT-X----BoX--M||M--|M---------|-?B--X---X-B--BE-E-E-EX-|-EX---XM-|-EE---E??-|--|-?-T?-o-?E-?-|-M-----B----X|--BB|
T-|----E-----X----Moo--B-MoX----EB-T-X|---T--o-|---X-|-?------oT-----X---|-----M-?E---oT--X-TM-B---E-B-?--|----?-?--|T------?----X---E-E----X-----B-|---?--|ET---------------|-?---o-B|----MB--|-TX-oTMo
M--?T-TX-o-T----T--?o-M---Mo-BBMB-M--B--M-TBE|E-T?T-o-?-|---B-M-X-T--B-X---M-|M-X?T--T-----------TE--|--|----X|-?o--|-T-E--X-|-?-----?---M---o--oT--M-E--X?Mo--??-?--o-------M-?B-X---T-|--E----?-T?|o-X
o-------B--oM?TM----M-Xo--X-BB-T?---XTX---o-T-?-B----B-?MBMT?-B-|--?-?-E-BMXoo----|X-------XM-MX--|M-TE--X|o-MT---|--TE-?X--TB|o-MB-??M--?-T---?-|o-TM-B--o------|---MB-M-?-o?To--M-X?oB?X----E-||-EoMEo
o|X-|-?---XX?-X-|-o-----XX---B-M--T---?--M?-E-Bo-----|-BEB-T-T|TE-Mo-?T-?E-?--?X-T-----oE|X---?-X-X--E---X?-Eo-X-B--M----oT-BT?TB-M|-MEB-BXT-E--?--T-EMM?-XXE-E---M--XE-MT-TX--T--EE-|---T-X-?-?--BMo--B
EXT?-XM----X?o---o-||E--o--XXT--|--X---?|-o--T?B-?EX-BB------M||o-M-?---TT?B-----|T-oEXB-T||-B--B---X---|o|?-MB---Bo-E-||-------T??----B-----T---?-B---oB-B?--|-TEE---MTT?-o---------|?-TT--To--T------o
mE-T---o--M-o-?--o--EBB-|M----|--X---E-B-E|---------oXo-|B|M--?-Eo-E--M--E---T-----|-M-?-?X-BM|-?-----E--XT|T-?M---EE|-E---Eo-XB-o---?|X-B-o-E|--o----Too-|B---|-E|T?|-X---oTo?-XX|-M----|ET-------|X--|
XXXXXXXXXXXXXXXXXXXXXXXXXXXXXXXXXXXXXXXXXXXXXXXXXXXXXXXXXXXXXXXXXXXXXXXXXXXXXXXXXXXXXXXXXXXXXXXXXXXXXXXXXXXXXXXXXXXXXXXXXXXXXXXXXXXXXXXXXXXXXXXXXXXXXXXXXXXXXXXXX-XXXXXXXXXXXXXXXXXXXXXXXXXXXXXXXXXXXXXX
