-------X-------B----------------------------------------------------------------------------------------------------M-----------|------------------------------------------------------M----------------
-----------------------------------------------------------------------------------------------------X-------------------------------------------------T-E-------------E------|-------------------------
-------------------------------------------------------------------------------------------------------?--------o-------------------------------------------------|-------------------------------------
--------------------------------------------------------------------------TE----------------o------------------------------------------T----------------------------------------------------------------
----------------------------------------------------------------------o---------------------------------------------------------------------------------------------------------------------------------
---M-----------------------------X-------------------?------------------------------------?-----------------------o--------------------------------------------------------------------M----------------
---------------------------------------------------------------EM-------------------------------------------|---M--------------X------?-----------------------------------------------------------------
--------------------------------X--------------------------------------------X-------------------------B-----------------------------------------------------------------------------------------------v
-------X-?-------------------------------------------T--o------------?---------------------------------------------------T-----------------------------------------------------------------------------f
------------------?--------------------------------------------------------?---------------------------------------------------------------------------------------------------------------------------f
-----------------------------------------------------------------------------------------------------------------------------|--------------------------------------o-------------X-----|--------------f
------------?------------------?---------------------------------------------------------------------B-----------B---------|----------------------------------X----------------------------------------f
---------------B-------------------------------------------------|-------------------------------------------------------------------------------------------------------------------------------------f
----------------E---------M----------------------------------------------o-----------------------------------------o-----------------------------------------------------------------T--B--X--------B--f
m-------------------------------------X----------------------------------------------------------------------------------------------------------?-|---------------------------------------------------X
XXXXXXXXXXXXXXXXXXXXXXXoXXXXXXXXXXXXXXXXXXXXXXXXXXXXXXXXEXXXXXXXXXXXXXXXXXXXXXXXXXXXXXXXXXXXXXXXXXXXXXXXXXXXXXXXXXXXXXXXXXXXXXXXXXXXXXXXXXXXXXXMX|XXXXXXXXXXXXXXXXXXXXXXXXXXXXXXXXXXXXXXXXXXXXXXXXXXXXXX
