--------------------------------------------------------T-----------------------------------------------------------M-----------------------------------------------|-----------------------------------
--------------------------M-------------------------------------------------------------------------------------------------|--------------------------T------E-----------------------------------------
--------------------T--------------------------|-------------------------------------------------------?--------o-------------------------------------------------|-------------------------------------
----------------------------------------|----------------------------------------------------------------------------------------------T----------------------------------------------------------------
-----------------------------------------------------------------------------------------------------------------X--------------------------------------------------------------------------------------
------------------------------E--X------------------------------------B-------------------?----------o------------------------------------------------------------E--------------------M----------------
-------------------------------------------------------------------------------------B--------------------------M--------------X------?-----------------------------------------------------------------
--------------------------------X------------------------B--------------o----X-------------------------B-------B-------T----------------------------------------------------M-----------------o?-------v
-------------------T-----------------------------------------------------------------------------------------------------T------------------T----------------------------------------------------------f
--------------------------T------------------------------------------------------------------------B-----------o---------------------------------------------------------------------------------------f
-----------------------------------T---------------------------------------------------------------o-------------------------|------------------------------B----M-----------X----X--------------------f
----------------------B----------------------------------------------------------X-------------------B-----------B--------------------------------------------X----M-----------|-----------------------f
---------X-------------------E--------------------------------------------T-----------|----------------------------------------------B-----------------------------------------------X-----------------f
----------------E-----------------------M--------------------------------------------------------------------------o-----B---------------------------------------------?-------------T-----------------f
m------------------?------------------X---T------------------------------------------------------------------------------------------------------?-----------------------------------------------------X
XXXXXXXXXXXXXXXXXXXXXXXoXXXXXXXXXXXXXXXXXXXXXXXXXXXXXXXXXXXXXXXXXXXXXXXXXXXXXXXXXXXXXXXXXXXXXXXXXXXXXXXXXXXXXXXXXXXXXXXXXXXXXXXXXXXEXXXXXXXXXXXXX|XXXEXXXXXXXXXXXXXXXXXXXXXXXXXXXXXXXXXXXXXXXXXXXXXXXXXX
