---------?------|------------------------------------------------------------------------------------------------------E-----------------------------X---------T----------------------------|-----------
----------------------------------------------------------------------------------------------------------------------------------------------T---------------------------------------------------------
----------------------|---------------------------------------------------------------T---------------------B----------------------------B----B--------------------------------------M------------------
---------------------------------------B--------------B--T--------------------------------------------o---------------B-----------------------------X-o-------------------------------------X-----------
--T-------------------------------------------------------------|---B--------------------------------------------------------?--------------------------------------------------------------------------
--------------------------------------------------------B-------------------X----------------------------------------------------------------X-----------------------B----------------------?-----------
--------------------------------------------------------------------------------------------------B-----------------------------------------------------------------------------------------------------
--------------------------------------------?-------------------------------------------------------------------------------E------------X-------------------------------------------T-----------------v
-------------------------------------------------B-------------------------------X---------------------------------------------------------------------------------------------------------------------f
------------------------------------------B----------M------------------------------------------------------------------M-----------------------E------------------------------------------------------f
-------------------------M----------------------------o------------------------------------------------------------------------------------------------------------------------------------E-----------f
--------------E--------------------------------------------T-----------------|-------------------T----------M-----------------------------------------------------------------------E------------------f
---------------------------------------------------------------------------?---------T--------o-------------------------------------------------------o------------------------------------------------f
-------------------------------------------MX--------------------------------------------------------------------------------------M--B------------------------------X-E-------------------------------f
m--------------|--X-----------------------------------------------------------------------------------------------------------------------------E---------------|---------------------?----------------X
XXXXXXXXXXXXXXXXBXXXXXXXXXXXXXXXXXXXXXXXXXXXXXXXXXXXXXXXXXXXXXXXXXXXXXXXXXXXXXXXXXXXXXXXXXXXXXXXXXXXXXXXXXXXXXXXXXXXXXXXXXXXXXXXXXXXXX-XXXXXXXXXXXXXXXXXXXXXXXXXXXXXXXXXXXXXXXXXXXXXXXXXXXXXXXXXXXXXXXXX
