---B----?------?------------o-------o---?------------oo----------M-?---E----?---------------------------o--------?----------E-----M-------X-?------o----X------------B----------B-----o-----------------
--------------------------------E---M-----?----------------T----------T------T------------------------XX---------?----E------E-------------------M-----X-M--------------------------------M-----E-------
---T--------o--------o---X--------T---------M--------------?--?-------XM--B--M------------E-----M-----o--XM---E--E----------------------ME----M--------?--------------------------------------E-----M---
---M-------X--X-----E---E-------E-M---------------X------------X------?-?M--B--------------------?----------------------------X?----------T--X---M?T---------------------E---------?----?--------E------
----T----E---------------?-M-?X--------X---M--------X----?------------------------------o?----------ME-----------------B---B--------------M-T--M---|-------------X--------------M------B---------M-B----
----X--E------------?-----------------o-?----------------B-------X----------B------o-----------------------X------X--------?----o-----------?---M--|-o---X---------o----------X----o-----------B--------
----?--------------T------T----------o-E--------------o-----X-------------E------M-?---?------------------------?B-----oT----E-----------------B--M|-?--------X---X-----B--------------T---B------------
-------------------X------X----------------------E-----------B---M-B--------------------E------------X-?-?-X------------M-------------E-----B--o---M---------X----o---M-B?-B-----------M??----B-----o--v
----M-------X---------------------M--?--BX---E---T-ME--o--------------X--B-------------------M--B---------MX--------------M-----------XB--?---o---M---------X--------M---E-M-----------B-E-------------f
------E---------M-----M-----------E-------------o?---------------------??---------------------------o---------------X-----------T---------Eo-----o----XE---------X--o-----B---??-----E-B-M-------------f
----------o-B-------E------------M--B?-B---------------B----X--X--------------oM---------------oB---E------o-----?----M-------?-M------?-----------o-------------M------------E------M-----------X--E--f
------------?--------?-----E--------E----------o--o----?--------------o-------B---?---?----o--?------------------------o-------M------X------B----------T--E-----------------X-----------X-------------f
------------------------------------M----------------------------------------------------------------------------------?----------?M--------------------|---?-T--X---------------------------XX---E----f
-----ME---o----?--M--M-------B--o-?--------------------------------T---------------------------------------B--B--X-----?----------B------E--X-----------X-----|-T--B---------o----?--------------?-----f
m-T-------------o------T------T-----E---------------------M--------|------------T---------------------------B-------------------?----------oB----M------------M-B----------------------T---------T-----X
XXXXXXXXXXXXXXXXXXXXXXXXXXXXXXXXXXXXXXXXXXXXXXXXXXXXXXXXXXXXXXXXXXXXXXXXXXXXXXXXXXXXXXXXXXXXXXXXXXXXXXXXXXXXXX-XXXXXXXXXXXXXXXXXXXXXXXXXXXXXXXXXXXXXXXXXXXXXXXXXXXXXXXXXXXXXXXXXXXXXXXXXXXXXXXXXXXXXXXXX
