----------------------T-------|-----------------------------------------------------------------------B----------------------------------B-----|--------------------------------------------------------
-----------------------------------------E----------------------------------------------------------------------------------|---------------------------------------------------------------------------
--------------------T--------------------------------------------------------------------------------------------------------------X------------------------T---------------------------------X---------
----------------------------------------o-------E-------------------------------------------o-------------------------------M---M------------------------------?------------------o---------------------
-o----------------------------------------------------------------------------------------------------------------------------------------------o--------------T----------------------M-----------------
----------------------------B-----------------------------------------------------------------------T----------?--------------------B-X-----------------------------------------------------------------
--------------------------------?----------------|-----------------------------T--------------------M---------------------------------------o---------------------o------------------------------T------
---------------------------------------------------|---------M-------------------------------------------------B-------T-----?-----------------------------------------------------------------?-------v
------------------------------?------------?------------------------|---------------E--------|---------------------------------E-----------o-----------------------------------------------------------f
--------------B------------------------------------------------------------------------------------B-----------------------------------------------------------------------------------o---------------f
--------M?-----------------------------------------o--------------B------------------------------------------------------------------------------------------------------------------------------------f
------?-------------------------|------------------------------------------------X-------------E-----------------------B--------------------|--------------------------------o---B---------------------f
--------?--------------------E-------?-----------X-------------------B---------------------------------------------------------X-------------------|----------------------------------E----------------f
--------------------------------------------------E------------------------------------------------------------------E---------------------------------------------------------------------------------f
m-------------------------------------------------------------------------------------------T-----------------|------------------------------------------------------------T|--------------------------X
XXXMX?XXXXXXXXXXXXXXXXXXXXXXXXXXXXXXXXXXXXXXXXXXXX|XXXXXXXXXXXXXXXXXXXXXXXXXXXXXXXXXXXXXXXXXXXXXXXXXXXXXXXXXXXXXXXXXXXXXXXXXXXXXoXXXXXXXXXXXXXXXXXXXXXXXXXXXXXXXXXXXXXXXXXXXXXXBXXXX-XXXXXXXXXXXXXXXXXXX
