--------------------------------------------------------------------------------------------------------------------------------------------------------------------------------------------------------
-----------------------------------------------X--------------------------------------------------------------------------------------------------------------------------------------------------------
--------------------------------------------o-----------------------------------------------------------------------------------------------------------------------------------------------------------
--------------o---------------------------------------------------------------------------------------????????--------------------------X---------------------------------------------------------------
-----------------------------------------M---------?-----------------------------------------------------X------------------o------------------------------------------------------------B--------------
-------------------------------------------------------------------------------------XXXXX--X-----------------------?---------------------------------------------------------------o-------------------
-------------------------------------------------------------------------------------------XX----------------------------------------------------------?------------------------------------------------
------------------------------------------------------------------------------------?-----XXX---------T--------------------------M---------------------------------------------------------------------v
-----------------------------------------M----------------------------------B------------XXXX---------|------------------------------------------------------------------------------------------------f
-----------------------------------------B----------------o-----------------------------XXXXX---------|---o---------------------------------------------------???????----------------------------------f
----------------------------------------------X------------X-----X---------------------XXXXXX---------|-------------------------------o----------------------------------------------------------------f
---------------------------------------------XX-----------XX-----XX-------------------XXXXXXX---------|------------------------------------------M----------T------------------------------------------f
--------------------------------------------XXX----------XXX-----XXX-----------------XXXXXXXX--BBBBBB-|-----------------------------------------------------|------------------------------------------f
---------------------------o---------------XXXX---------XXXXXXXXXXXXX---------------XXXXXXXXX---------|-----------------------------------------------------|------------------------------------------f
m-----------------------------------------XXXXX--------XXXXX--E--XXXXX-------------XXXXXXXXXX---------|-------------------------------------------------E---|-E--------------------------E-------------X
XXXXXXXXXXXXXXXXXXXXXXXXXXXXX-----XXXXXXXXXXXXXXXXXXXXXXXXXXXXXXXXXXXXXXXXXXXXXXXXXXXXXXXXXXXXXXXXXXXX|XXXXXXXXXXXXX-----XXXXXXXXXXXX-------XXXXXXXXXXXXXXXX|XXXXXXXXXXXXXXXXXXXXXXXXXXXXXXXXXXXXXXXXXXX
