---------------------------------------------------X--M---------------------------------------------?---------------------------------------------------E-?---------------------------------------------
--------------------------------------------------------------------------------------------------------------------------------------------------------------------------------------------------------
---------------------------?---------------------------------------------------B--------E-----------E-------------------------------------------------------------------------------B-------------------
-----------------------------B----------------------------------------------------------------------------------------------------------T-----------------------------------------------------------|---
-----B---------------------B--------------------------------------------------E-------------------------------o-------------------------------------X--M----------------E-------------------------------
-------------------------------------------------------------T------------------------------------------X----------------------------E-------------T----------------------------------------------------
---|------------------B----------------------------------------------------------------------------------------------------------------------?-----------------------------------------------------T----
---------------------------------------------------------------------------------------|-------|------------------------T------------------------o-----------------------------------------?-----------v
-----------|------------------------------------------------------T----------------------------B-----------------------------------------------------------?T------------------------------------------f
----------------------------------------?-|-------------T-----?-------E-----------------------------------------------------------------?--------------------|-----------------------------------------f
----------?-------X-------------------|----------------------------------------------------------------------------------------------------------------X-----------------------------------------------f
--------M-----------------------------------------------------T------------X---------o----M-X--------------------------B--M------------------?------------------T----------------------|---------------f
------------------X---------------------------------------------------------------------------?---------|-----------------E----------------B------M----------------------------------------------------f
------------------------------------------------------------------------------------------------------------------------------------------------------T-------T--------?---------X---------------------f
m--------------|----------------------------------------------------------------------------------------------------------------------------|----------------------------------------------------------X
XXXXXXXXXXXXXXXXXXXXXXXXXXXXXXXXXXXXXXXXXXXXXXXXXXXXXXXXXXXXXXXXXXXXXXXXXXXXXXXXXXXXXXXXXXXXXXXXXXXXXXXXXXXXXXXXXXXX-XXXXXXXXXXXXXXXXXXXXXXXXXXXXXXXXXXXXXXXXXXXXXXXXXXXXXXXXXXXXXXXXXXXXXXXXXXBXXXXXXXX
