----XE-M--?M-----?------B-o----?MX--E---?--B---------?-E|----B-XM---------M--XX-B-E-----E?Mo------X-o--?E-EEX---?E-XMo-?Xo-o---XB--?-XBM-------X---?B-o-----?-XBE----?-----B--------Eoo--E--------?-B---
-M-oB---E---o---E---o-E--o-oX--E------XM-E--------|?-M?M--?--E-M-TM?----M--o---o--X----o--EB--?-?o-?-EB----M-o-o------------E-B--X-?--MM--------?------B---E-B|-E?---MBBEB--?-MT--o-o----?o--?-?-MM--?--
-M--?---X--o?--?-----E--M----E-?---X--B?B-EB--?----?--XT----M-E--o--M-M----X--B?------B-B------?o---??-BEE-------oB-M---X--ET---X?---E---?----?------B?-?-o---------o-X-?--EE---B---?-?----------EM--E--
--E--B---BX--M--X-?-B|-?M----M-XE--o-B??-M----M---X-?o-----E-M-?-EM-------?---T?--X---?---B?oX-X----E--?--o--X--X-?--M?Bo---BE-MX---oM-----B---E-M--o---B----EE--oXX-E---oE---oM------o-Eo-E-----o-EXET-
--B--B--?-E-----XBB-E----M-----E------B-?---BM---?-------??------X-M-----MB-B-E--------E--M-----BM-oE--E?---M-E---B---E--X---?XXE-EB---Bo---E--o--X-o--M?-------o|X-o--?-X----E-?------BM-----?--MB-----
-oMX-X--oXEEB------X-X-----------E---|?B?o-?---o-ME-E-ME?o--?E---oXo---?-EX------Mo--o--M--X-X--M-B---oX-------X-----?-------X---?BM-----E-ooXBM?M-----o--o|M-X-E-M--oBM-Xo-o------oEEXBE----X--MB?-o---
-o--M--X-?-MM-B-----------?---XBE-?-X--M--?--E--o---XE--oE--------E--BXM------E---oX--X-M--------E-o-Eo--XEXX--o----M--?--E----?-X--E--M-----X---B--B---o---X--X--MX--EE--o-E-X-M-EoEo-B-BM--Bo---M-?EX-
-------EB-Eoo-?----B------------o--M-----E-?-----?-oX--E-?X---M---E-oo-?E?--------X--MX-E--MX-T-------o----E--?--E-E-Bo-E?E----?T-BMB----o---------o--MB----B------------?--?oEM?--E--M--TE-?--B---E---v
--E---o--oM|--M|?---X--XXMXM-X-o--?---B-BX-M-----X-Bo---o?E-M-XX-E-?oMBX--?X-M--?--M--o-o?----?--|B----oM-?-----Mo--E-oM--BB----?B-XM---o---?M---EE----XETM-?---M?-?--?-?oM?o-----Eo-E-MX---XB--oX----Xf
-----o--XM--EM|-XX--E---o--XX--XX-X--------?X-?M---EBX-----X-EoE--?T--o----?-----BE-EX-ME------|-B-----?o-----B--o----XE--oT-E-Mo--B-BBM------o---M-o----M---E---To-EB--?M---B---|--o---?-----oo--o----f
-?--XX-------?---E-oM-?-EM--XM---EBo-B--Bo--E--?-E--XM?T--XX--EMB---X-------?X--o-----B-??--M--oT-----T-?XX--BEEo---oo----EE-X?----B--?oX?--------E?-M?-X--o-o--BBoo-M-X-------M|TX-T---------o---X-|-Bf
-----ET--?T?-T-T?--B-----TT------M--?|-T--o-B--X-M---X---EM---T-E---o-TTT-----T?o----------M---?|--M--|MT--TE----?-----|-BMT-B---TT-EETM-----Mo-T---------?E-o---B--BT----T--o---T--|T|-B-B-M-TEM-TEXX-f
--T---|TTX|-||-?TT--E-T-o|TB-TM|TT-T-XT|--o---Eo-?T-T--|-B-T-E|-ET-|TT?||BT-?XTTTTT-E-TT-TT-X|-||BTT--|-T-X|---XoT-MTTX--oE|T-T--||-TTM--ToT--o-|----M--XT--|B-TT-TTB|-ToE|TTTT-TTT-||T---oT-|--T?-TTBTf
-T|TTB|TTT|T-TTT||--TT|TT||-T|TT||T|TT||T-XTT-TTT-T--T?TTTT|TT|TT|-T||T||T||-T|||||TTT||-||TT|TT|T||T-|T|T-|TTT-T|--T|M-T-T||-TTTT|T-|-TX|TTTTBT|TTT--oTT|TTT|T||oT|TT-|E-||||TT|||T|||-TTTT-T--|-T|TT|f
m||||-|-||||-|||||--|||||||-||-||||-|||||M--------|--|-|||||||||||-||||||||--||||||||||--|||--|||||||E|||--||-|-||--||--|?|||---||||-|--?|--||-|||||---||||-|-|||-||||----||||-|||-||||--||--|--|-|||||X
XXXXXXXXXXXXXXXXXXXXXXXXXXXXXXXXXXXXXXXXXXXXXXXXXXXXXXXXXXXMXXXXXXXXXXXXXXXXXXXXXXXXXXXXXXXXXXXXXXXXXXXXXXXXXXXXXXXXXXXXXXXXXXXXXXXXXXXXXXXXXXXXXXXXXXXXXXXXXXXXXXXXXXXXXXXXXXXXXXXXXXXXXXXXXXXXXXXXXXXX
