----------------------------------------------------------------------------------------------XXXXXXX-----------------------------o--------------------------------------------------------------?------
------------------------------------------------------------------------------------------------------M-------------------------------------------------------------------o-----------------------------
--------------------------------------------------------------------------------------------------------------------------------------------------------------------------------------------------------
-------------------------------------------------------------------------------------------------------------------------------BBBBBBB------------------------------------------------------------------
-------------------------------------------------------------------------------------------------------------------------------------------XXXXXXXX-----------------------------------------------------
-------------------------------------------------------------------------------------------------------------------------------------------?------------------------------------------------------------
--------------------?????--------------------------------XXXXX-----------------------------B------------------------------------------------------o----------------------------M------------------------
---------------------------------X----------------X-------------------------------------------------------------------------------------o------------------------------------M-------------T-----M-----v
--------------------------------XX-----------------------X-----------------------------------------------o-----------------B--------------------------------------------------------?------|--------B--f
-------------------------------XXX---------------------------------------------------------B---------------------B------------------------------------------B------------XXX---------------|-----------f
-BTBBBBBB----------------T----XXXX--------X------------------------------------------------B----------------------------------------------------------o---------------------------X------?-|-----BBBBBBf
--|----------------------|---XXXXX?--------X-------------------------------------------------------------------------------------?-----------------T------------------------------XX-------|-----------f
--|-----------------T----|--XXXXXX---------XX---------------------X----------T---------------------------------------------------------------------|----T-----------X-------------XXX------|-----------f
--|-----------------|----|-XXXXXXX---------XXX-------------------XX----------|------------X-------------------------------------T------------------|----|---T---------------------XXXX-----|-----------f
m-|-----------------|----|XXXXXXXX---------XXXX-----------------XXX----------|-----oE----XX----------------------------E---E----|--E--------E------|----|---|------E------???-----XXXXX----|-o-----M---X
XX|XXXXXXXXXXXXXXXXX|XXXX|XXXXXXXXXXXXXXXXXXXXXXXXXXXXXXXXXXX--XXXX?-XXXXXXXX|XXXX------XXXXXXXXXXXXXXXXXXXXXXXXXXXXXXXXMXXXXXXX|XXXXXXXXXXXXXXXXXX|----|---|XXXXXXXXXXXXXXXXXXXXXXXXXXX--X|---XXXXXXXXX
