------------------------------------------------------M-----------------------------------------------------------------------------------------------------------------T-------------------------------
-----------------------------------------------------------M--------------------------------------------T--------------------------------------------------------o--------------------------------------
-----------------------------------------X------------------------------------------------------------------------------------------------------------------------------------------------------------T-
----------------------------------------------------------------------------------------------------------------------------------------------T--------------------------E------------------------------
-----------------------------------M-------------T--------------------------------------------X-------------?-------------------------------------------------------------------------------------------
-------------------------------------------------------------X---------T---------------------------------------T--------------------------T---------------------------------X---------------------------
----------------------------?---------------------------------------------|---------?---------------------B-|---------------------------------------|----------------|----------------------------------
----------------------------------------------------B----------------------------------------------------------------------------------------------------X-B-------------------------------------------v
-----------------------------------------------------T---------------------------------------------------------------------------|------------|---------B--------------T-------------------------------f
--------------------------------------------------------------T-------------------------------E-------------------------------M---------------------------------------------------|--------------------f
-----T-----------M----------------------------------E--E------------------------?-------------------------B--------------------|----|--------------------------------------o---------------------------f
--------------------|----------------------------B-------------------------B-----------------------------|----------------------------------------|---------------------------------------E------------f
-------------------X---------------------------------------------MM----------E-----------------------------------------------------------B----------------------------------?--E-----------------------f
---------------------?----------------------------------------------------------------------------------------------------------------------E----------------------B-----------------------B-----------f
m----------------------------------------------------------------------------------------------------------------------------------------------T-------------------------------------------------------X
XXXXXXXXXXXXXXXXXXXXXXXXXXXXXXXXXXXXXXXXXXXXXXXXXXXXXXXXXXXXXXXXXXXXX|XXXX|XXXX-XXXXXXXXXXXXXXXXXXXXXXXXXXXXXXXXXXXXXXXXXXXXXXXXXXXXXXXXXXXXXXXXXXXXXXXXXXXXXXXXXXXXXXXXXXXXXXXXXXXXXXXXXXXXXXXXXXXXXXXX
