--?---E--X-EB-o--TXTX-?E?EoM---o--XM----B-XE--EB-|T-??---?-----X--T-T|?-oT--|XM-X?---B-----XM-oME?TME?MM?TT--oXX---X?-o--B-XM---TMM--o-?B?---T??--oEEBE---------o--X-XE|-----oM---|E--o--B-B-|-|M?----X-
-oB--E-X-------EE---X|oE-?T-|E-?MB-|--?-MT-ooo--EM-|--M---E-Mo-M-E----EEB---?--|EEM?B---BX-----oBX------||--Xo---o-T---?--o----?-E-XB----M----|---?--X-o---E-TE---E-X-|-TB----EE-----XX--oX-X--|--|o--T-
-T-----E-?--E--------XT---E-B----M-?ME-?EMXME|?-X---?-o?Mo?-o-B--B-|--ME-ET---o-M-----------XX----?--XM|-T-MX--?M-------MoT---o-TB|E-|-----E---B-----|-T-?----E----o--M?E-oo-E?-?B----M--T-oM--?--TETE--
---|B-|-E-BXX----oMo---o-TX-?-----T---M|oM-?T--?EB---o---M---X-|MEM|-----oXoB-MX--T-----E----X-?--|?|o||XX---B--||-----?Xooo?------|E-E-BE----|-|T|?-Eo--|-M-MB?T|---?E?BE-----?X-B----|----B-X--E-?BEM-
-----------Xoo-?---E-T---Eo--?Bo--X-XE-|----|--oo-?|--MX-E----oEM-|-X--T|-E---o-M----M??|M---?---TMMBM--XM?X---?--T--o--X|?-|BB?o---E-MTX-?|--XXX---XM|M-ooX-BT----BoB--EET-B-E?--BEX-MX-EB-B--E--X-E---
-E---E-?--M-?--E|ET|--BE|-----------------M|-oM|-BEE--|BMo-T?o-?---?----T-ET-?----E?-X--|---|XMEo-XB-X---o?TM--------B---|-o|-X----T-----MX-----X--TEo---oo-B-TE-BT--TX---??M-M-----Xo----X-?T---oo-ET--
--X-TEM-MM--o??BBM--?X--B-XM--|T?---M--M----o-X-----BE--?----X--oT-?----E--oT-BEX?X---MEBB--?-B----B-EE-oTBTX---BM--TooT-T--MM?E-X-|E-E|-T-----B-E---B-Xo|--X?---M----M--?-|-BX---|-oT|-o--M|-E---M-?---
-o-X--M-E-o-M-----MEM|-oT---T--o--M-|B-|-E-?X--?--|E---XoXE--XMX--M|oM-X-MX-o-----T-|-MX--B--MM-EX-?|-?-|----T---E|BB---oM-Mo----B-XE-X?B------|-X?--E--X-B?---E-??-|-------o-B-TB---T-?XB-oTo-MX-TBo-Ev
-oTo-M-o-?-M?--XXB|----o--B--T----|--TX--|M--??o-?-XB---|B---BXE-oE----ET---T|o--|BB-?MXB----XX--|--|--E?|Bo-o?-X---E--------B--?---T-o?-----?X--TE-?-?---E----?--?--XT-?---??---T----?M|ooM---T---B---f
-T---MB----MT-----||M-o--|MX----?E-oMT---M--E---X--EX---BB?oE----o?-B----M-TM-??--E----EB--Moo?oo-----?---M-T-?-BEo-----o---B?|-------|o-----T-o---M---EoT--MoM-E---B-B----To-XT?|E-B----?--?----o--T--f
--B--T--E-E--?------B--X|?-E-XTE--oo---|-T--M-BX---M|EM----?--|-?o--o---M----Xo--|MT--|o---o----|X--?--o--X--o-B----X------oE|?---|--?B-||---Eo-----TX|X-T-|-B-XT--?-------TEE--|---?BX?|---X---o--XE-of
-X|M-T-T-X?-M?--M------XXX-Xo--?-E--?X---|--?-?-M--E--B-ET|o|--|--|T-oT--o-?o---EX-EETToo|BE--XT--EEE--XX-----o---|X---M-?-X-X-TX----?-X?oB-M|----|?----M?--?--T--------TT-o-o---T?-B-----B---TEMTXB-BEf
-MB--X--B-?|--T-----M|?o?-M-?T-ooB-T-o?o--EM-?-X--o------|----o--oT-o-oB-----E--T-T----MM|?--MTXE-M---T-o--?E---E-X-B?B--T|--B-T-X-?-?--oM|X-XB--TE-M--------|--o-?--o-o-?----BEB--oBE-o-BXM----o--?E--f
-o--|-X---?ETX??-EXooX|o--o---E-----------|-B?T----|To---||---B-----|EXoTT---BB-M----EE--o-|B---X-------o--T-B-oTM---o---|TEBB?-----TT?--M---BB---?----B--?oBMT---?--|-B-?------|----T---M-TXoM-M-||---f
moM-?XXX|--o-X--EM---B-BB-oB-XE-|BM--T-T---BBX|--MoXo------?--?-TM-oE----o---oB-|-?---XTX-X|-X-XX-B---BXXB----o-----oBXE-To-MBBo---------?X-?---M|--X-oTX----|TX--|-T-T--?-----|-E---Bo--B-----X-E-|---X
XXXXXXXXXXXXXXXXXXXXXXXXXXXXXXXXXXXXXXXXXXXXXXXXXXX-XXXXXXXXXXXXXXXXXXXXXXXXXXXXXXXXXXXXXXXXXXXXXXXXXXXXXXXXXXXXXXXXXXXXXXXXXXXXXXXXXXXXXXXXXXXXXXXXXXXXXXXXXXXXXXXXXXXXXXXXXXXXXXXXXXXXXXXXXXXXXXXXXXXX
