--------------------------------------------------------------------------------------------------------------------------------------------------------------------------------------------------------
------------------------------------------------------------------------------------------------------------------------------M----o--------------------------------------------------------------------
--------------------------------------------------------------------------------------------------------------------------------------------------------------------------------------------------------
--------------------------------------------------------------------------------------------------------------------------------------------------------------------------------------------------------
---------------------------------------------------------------------------------------BBBBBBBB-----------------------?---------------------------------------------------------------------------------
----------------------------------------------------------------------------------------------------------------------------------------M---------------------------------------------------------------
------------------------------------------------------------------------------------------------------------------------o-------------------------------------------------------------------------------
----------------------M------------------------------------------------------------------------------------------------------------------B--------------------------------------o----------------------v
-------------------------------------------------------------------------------------------------------------------------------------------------------------------------------------------------------f
-------------------------------------------------------------------------------------------------------------------------------------------------------------------------------------------------------f
----------------------------------------------------T-------------------------------------------------------------------------------T-----------------o------------------------------------------------f
----------------------------T-----------------------|-------------------------------------------------------------------?-----------|------------------------------------------------------------------f
----------------------------|-----------------------|-------------------------------------------T-----------------------------------|----------T----------------------------------------------------X--f
----------------------------|---------T------------?|???----------------------------------------|----------------------------------T|----------|---o---------------------------------------------------f
m---------------------------|---------|-------------|-----------------------E-------------------|------E--------------E------------||----------|-------------------------------------------------------X
XXXXXXXXXXXXXXXXXXXXXXXXXXXX|XXX---XXX|XXXXXXXXXXXXX|XXXXXXXXXXXXXXXXXXXXXXXXXXXXXXXXXXXXXXXXXXX|XXXXXXXX--XoXo----XXXXXXXXXXXXXXXX||XXXXXXX---|---XXXXXXXXXXXXXXXXXXXXXXXXXXXXXXXXXXXXXXXX-XoXXX------X
