------|----oBEB-?E----X--TE--X--B--T-o-T----M---||-oBX---oE-o---??-B------|XT?--|ETo??-?-MM---EX--T?--------B----E--EX------o-?-?EBT--|B-E-XME-E--|o-B-E-XM-?|B--E-B|---MTE|--E-M-XT---Eo------|--M--X--
---EE|ME----TM-?BE--?-TX|---M-----X---E----M-T-B-EM-E---B------BM-MM-To---M-E-E--M-|MX-?-|-BBE-----B--B?MT--TTX-X-BT--T----?E-oB-M--Mo--?M--o-To---B-------oMBBoT------?B---TE---T---MX-E--M|-Eo---BM|?-
-M-B--E---B?M----E--X----B--B--o----E----?-X--MM|oM-o-T-BX-?-E----oMB--o-B|----MB-------M?--Mo-Bo------M|--Mo-o-BBBB----B-oMXT----M-|X----?-BE?---X----o-E-?---|??|--B-||EX----|-o----ooT---o------X----
---X-TX---Eo?-X-|---?---B---X------EX-T---o?X|?X-X-|-T-oo-?|--BXET----E-E--MMXX---MT----T--BX-E|?BXM-|o-----o--E------XBBX-X-o-|---o-T-o--M--E-EX----------B--?-BEM--E-MT--Xo-X---B-M?oo-E---EMoo-o-----
-?X--BM-B|T--o-o---M-?M---MEX-oXX--X?---M-|E|----o--B-|B---E---------E-?---ToE--|-XEE---XT-----|X-M-------X---M?--?EM-B---M-|ME--EXM?----|-EB||Eo---M-BB----T-M---------MT--XTT--BM-|-E-E-TM-|?-M-ET|M--
-B-B----?T---M?--o--E|M|X-E--BM-o-MX-T--X-X---E-??-B--T---?-|BX-XX--T-X-E?o-------B-|-XB--E--XX----E-M-||o-|?XT--T-?----E----T---?o--M|oE----o-|--E---?-?E-B--X|T--X-X-M-T----M-E-T-|-B|----|-?X--T-?|--
-M-?-E|oXM---EX?-BBEo-T-B---oo?-TEEX--XT--XBE--||--|----?M-|?----M-----?-o----o---B-M|-E-?---E|Mo|EB---M------o|--E|--ToEM?M-----M-E-B-|-X--------E-?--E|-||--B------|---X--|M?--M-MB--X--B---M--E-MX---
----|-TX|ETBX-B--?--|-|MB----M-To-oM-MM--X--|--E--BTM-?M|?MT---|B-|--T-----o--M?--T-XE?X-B-?--T-?-EX-M-X-|o---M--|?--?T|---o---Bo--E-o-|T---B--B--T|B---E-EE--|-M?--B--B--?-MoXT-Eo--B-oX----MB-?-M-M-Tv
-EX---B---B---o-M?--E----o--?X|X---X-|--|-M---XTE-----?-X|--|o-M--?E-o---oBoo--BT??----|-EXT?-??-?T?-E-XE---X-----EMT--?-EX|M-B--|E----M?XXT|M----E-B--?-M-?T-T|X|oMB|-X?---B-|-?-XT---B--B--?-M---Mo-of
---E--?--M----T-------B-o---oE|--Mo---|--X-X--|-X-MTM-?T--|-B-BX-----B|E|---XXT-?-----E-EB--o-|E-o---T--EE-EX-T--oo?------X---T--X-----o----?XM---------TM---E|?E--B--E--X--T-B-?---M|------------?o-|Bf
-E-----XX--TET--oM|-B--?X-?|T-MT---oX?E-XXM-B--ToX?B--EMoEB---M-T---TB--?TTTE-T---XT-X-|X-o-B--o--?-|E--X-----B-TM-----M-M-------o-M-----E-Mo----M-----o---E-oE-EE-T--o?o-|---oM--|TX---|-X-Xo--X--TT--f
-X------B-BE?o-?--ToB---M---|B-o-?----|B--|E----?XM--|---E|----TB-X-XEBT-X|-ToB|-M|B--M-M-X--??--o--X---X?X---------M--To?o--M--M-o--EM---?B--T-E?M-oE----T-MB--oo-TT?BT--X-BTo-M-|-T|o------X-M------Tf
-M--oMX-|EE-E-o?X---oMX----X-----EXB-B--T---|-oBXBo||oXET-T--|MM----T?------B?-B--o---X-MM-EX---o-MT---TM----T-TE-------T-MM--E-B-o--T-TMB-|---|X----BM-o---TXoB-X----|----oX-XE?----o---E-----X-MX----f
---|-------E------|-o-E-?E-TT-ME---X---M-M-B-|------TXE-E-BXT-----BME-?--Mo-ME-|B--?----oB--?E-|-|--E-B-B--M--|----M----TB--T|T-BXX|----?--E?-|E?TBo--B-T-T--oB----BM---ToMXX-|--oM----X---X-|-Eo--?MBof
mM--ME--?-BT|BE---X-B-X----o--M--?B-EB---M?ETBEoM--o|-B-------M--X--E-|EM|ooo-T??--o-|X-E---E--X--E---||B-M-?-|------EE--B-o-EE-X-B|--------T-E--M-E--?--M-?EXX--oM----??o-?o-|M-E?MM?--|oB--|-M?--||B?X
XXEXXXXXXXXXXXXXXXXXXXXXXXXXXXXXXXXXXXXXXXXXXXXXXXXXXXXXXXXXXXXXXXXXXXXXXXXXXXXXXXXXXXXXXXXMXXXXXXXXXXXXXXXXXXXXXXXXXXXXXX-XXXXXXXXXXXXEXXXXXXXXXXXXXEXXXXXXXXXXXXXXXXXXXXXXXXXXXXXXXXXXXXXXXXXXXXXXX-XX
