--------------------------------------------------------------------------------------------------------------------------------------------------------------------------------------------------------
--------------------------------------------------------------------------------------------------------------------------------------------------------------------------------------------------------
--------------------------------------------------------------------------------------------------------------------------------------------------------------------------------------------------------
----------------------------------------------------------------------------------------------X---------------------------------------------------------------------------------------------------------
-----------------------------------------------------------------------------------------------------------------------------------------------------------------T--------------------------------------
-----------------------------------------------------------------------------------------------------------------------------------------------------------X-----|--------------------------------------
----------------XXX--------------------------------------------?------------------------------------------------------------------------------------------XX-----|----o---------------------------------
------------------------?--------------------------------------------M-----------------------------------T---------------------------------------------?-XXX-----|-------------------------------------v
---------------------------------------------------------------------------------------------------------|----------------------------------------------XXXX-----|-------------------------------------f
--------------------------------------------------------------------------------X------------------------|---------------X-----------------------------XXXXX-----|-------------------------------------f
-----------------------------------B---------------?----------------------------------------------T----XX|XXXXX---------XX----------------------------XXXXXX-----|-------------------------------------f
------------------------????????--------------------------------------------T---------------------|------|-------------XXX---------------------------XXXXXXX-----|------o------------------------------f
----------------------------------------------------------------------------|-------X-------------|------|------------XXXX--------------------------XXXXXXXX-----|?------------------------------------f
-----------------------------o----------------------------------------------|-------XX------------|------|-----------XXXXX-------------------------XXXXXXXXX-----|-------------------T-----------------f
m---------------------------------------------------------------------------|-------XXX------X----|------|-E--------XXXXXX------------------------XXXXXXXXXX-----|-------------------|-----------------X
XXXXXXXXXX--------XXXXXXXXXXXXXXXXXXXXXXXXXXXXXXXXXXXXXXXXXXXXXXXXXXXXXXXXXX|XXXXXXXXXXXXXXXXXXXXX|XXXXXX|XXXXX---XXXXXXXXXXXXXXXXXXXXXXXXXXXXXXXXXXXXXXXXXX-----|BBBBBBXXXXXXXXXXXXX|XXXXXXXXXXXXXXXXXX
