--------------------------------------------------------------------------------------------------------------------------------------------------------------------------------------------------------
----------------------------------------------------------------------------------------------------------?---------------------------------------------------------------------------------------------
----------------E--X-------------X--------------------------------------------------------------------------------------------------E----------------|--------------------------------------------------
----------------------------------------------------------------?-X-------------------------------------------------------------------------------------------------------------B-----------------------
---------------------------------------------------------------------------------------------------------------B----------------E-----------------------------------------------------------------------
--------------------T-------------------------------------------------B------------------------T----------------------------------E----------------------------------------B-------------E--------------
--------------------------?------------------------------------------------------------------------------------------------T----------------------------------------------------------------------------
-----------------------------------------------------M---------------?------|X--------E------------------------B---------------------------------------------------B---------------------------?-o-----v
--------------------------------------T--------------------------------o---------------B---------------X--------------------------------------------------------------------------------------------o--f
----------------------|-----------------------------------T-------------------------X--------------B-------B---------------------T-----------------------------------X--------------T------------------f
-------------------------------------------------------------------------------------|------------------E----------------------------------------------------------------------------------------------f
---------------T-----------------------------------------------------------------X-B-E-------------------------------M---o----------B--B----------------------------------|----|--------------------T--f
----------X---X--------------E-----|----------------------------------------------------------------o-------------|--------------o-------------------T-------------------------------------------------f
-------------?-----------------------------------------------?--------------------|-----------------------------B------------------------------------------------E-------------------------------------f
mM---------------------------------------------------------------------------------------------------M-------------------------------------------------------------------------------------------------X
XXXXXXXXXXXXXXXXXXoXXTXXXXXXXXXEXXXXXXXXXXXXXXXXXXXXXXXXXXXXXXXXXXEXXXXXXXXXXXXXXXXXMXXXXXXXXXXXXXXXXXXXXXXXXXXXXXXXXXXXXXXXXXXXXXXXXXXXXXXXXXXXXXXXXXXXXXXXXXXXXXXXXXXXXXXXXXXXXXXXXXXXXXXXXXXXXXXXXXXX
