--------------------------------------------------------------------------------------------------------------------------------------------------------------------------------------------------------
--------------------------------------------------------------------------------------------------------------------------------------------------------------------------------------------------------
--------------------------------------------------------------------------------------------------------------------------------------------------------------------------------------------------------
----------------------------------------------------------------------------------------------X---------------------------------------------------------------------------------------------------------
--------------------------------------------------------------------------------------------------------------------------------------------------------------------------------------------------------
-----------------------------------------------------------------------------------------------------------------------------------------------------------X--------------------------------------------
----------------XXX--------------------------------------------?------------------------------------------------------------------------------------------XX--------------------------------------------
------------------------?--------------------------------------------M-----------------------------------T-----------------------------o---------------?-XXX-------------------------------------------v
---------------------------------------------------------------------------------------------------------|----------------------------------------------XXXX-------------------------------------------f
--------------------------------------------------------------------------------X------------------------|---------------X-----------------------------XXXXX-------------------------------------------f
-----------------------------------B---------------?----------------------------------------------T----XX|XXXXX---------XX----------------------------XXXXXX----------------------X--------------------f
------------------------????????--------------------------------------------T---------------------|------|-------------XXX---------------------------XXXXXXX-------------------------------------------f
----------------------------------------------------------------------------|-------X-------------|------|------------XXXX--------------------------XXXXXXXX-------------------------------------------f
-----------------------------o----------------------------------------------|-------XX------------|------|-----------XXXXX-------------------------XXXXXXXXX-------------------------T-----------------f
m---------------------------------------------------------------------------|-------XXX------X----|------|-E--------XXXXXX--------------------E---XXXXXXXXXX-------------------------|-----------------X
XXXXXXXXXX--------XXXXXXXXXXXXXXXXXXXXXXXXXXXXXXXXXXXXXXXXXXXXXXXXXXXXXXXXXX|XXXXXXXXXXXXXXXXXXXXX|XXXXXX|XXXXXXXXXXXXXXXXXXXXXXXXXXXXXXXXXXXXXXXXXXXXXXXXXX-----XXXXXXXXXXXXXXXXXXXX|XXXXXXXXXXXXXXXXXX
