B?X--E-----o|-E---X--T-E--o---------MT---|--E--M--T-T----BM|o--|-M--X-T--E--EB--X||X---|o-|-E-?X--Eo---TTTB-B---XMMB---E--|T-----M?--oE-----Bo-|XT?--B-TE-?---EXB-oE----X---E-------E?B-?--TTMMM--T--?-M
?E-|---E|M?|E-E----B---|-X---XTo--T---?--?---|-?E--Xo-----oM--|?-----|o--oT?EE-XE---X-T|?--T|-?T-M-?-----XTT---M-BBX--T-E-B||T-o-oX-EEo-?-EE--MBX|-|M----?-X|?---E|X-o|EE---XB-Xo-M--EE-T---TMMETB--oM--
?MM--T--?M?----TEToT-B-E--E---M|----M----X-----E------o--MET-TXX---o-?---X-?-M-B-B-MB?o--|-B-----T-??T--MT--?-?-|oo----|B---ME-TT-E-X-?-|EE--X-|B-------T--TT-T--B|-?o|TB?-|-M-EEB--oMMB---?--E-X----T??
E--|T---Xo---EB-|-?TM--||-?-B-X-T------T-||---o-o--o--MMX-X?-EX-?XM-XTE--E--BEM-M-----X??--|B-X|?----E--XM?T-----Xo------B--B-?TMM-o----|E||-E---?oo---Eo|T--|--oM--BT----M-E--o-?-?M|--X---|MBMo-E|T--|
TT-B--?X|B-M----E--T----o--o?--E-o-TXB-M--Bo-TMXXX-T?-----To--X?T--E||-B|-?-M----?X-M------E-E-BE-XE-MEE---MXXX|----XB-oEB--E-o--?--|--?-T----oMX-o--|-|---oMo-E----XET-M--o-|-B|---E-XM------M-?oM--oXE
X|-|TB----oMT----EX--B---o|--T|o--|E?----T----?---|-B|-TX-E-B--T-BB?-----B--o-|-B-oE---T-oo---E-?M-----E-B-B-|--|---X---TT-M?--|ET-----X--?--BX-M--B|T--------?|---M------M---X--|---E?-o--------E--?MEM
o-oo--oXM--ET---M------M---?--|MXB--BM-E|---TTE-E?-----BE--BTE-?-o---XBT---|---oo-----E|-T-X-M----X--To------Bo---E--E---T-B--BT-X?-X?------oXE--o-B--BT-T?|-o----|T-X--oMXB?---T-B--------XX--MM----X-T
---M-----o--M-T?TT---X?EBXBBX-T--T----?-|--|--||---MTEE--EB-|-X---|--oE------E|M?---ET----E-oM?---B-?|---X--TB-?XTTXo--?-|---?E----T----E-?--X?o-|XE-o--MMo-MX--|-B-oX-E--o-oXX|-E---M--o---?E-|X|B----v
?-T|-X|T--E-X-------|----o--|XET-----Mo--?E|T--BM|TX?|BB|---M---BE--oE-B---BMXX----?-?B-|E---------oXM---M--oB---oM-----TEXBX----T-B-?-o----BM--oE--M--XM--M-o-?---M-o--ET--B--TE|?-|--X-T-MX-B?XB|?oB-B
-|o----M-oB--E-----T---X-MBM--TX----E---?-T-B-TM-M---|XM--E-M---T---B-TT|B---M----o---|?-----X-TM---T-oX----o-----M--X---T-X---B|M|?-M--X------|T--B---M-B?o-?ETT---o-T|B-o-?-o--|M-E?-X-----T--|B--B---
o-M-B--?o--M----TE--B-MXXEX--EX-X---T|BE---o---|||---BX--BToE?--X---|-B-M-|-M--E|--?-----MM----|---?---T--|-|?-XBo-oTBE---|X---B-?-o-M----?----XM||o--B-----M-|o?----X--T-X--T-o-T---BB---EE-|---XM----T
|---B?---X--|?--o----XMEX-E----X?XXT-ET-E--Too-??---?MM---TE-X-----BX-M---|Bo--B-E---|-?MBMX--|-T--??-T?o|B-BM--T--XE--?-B----oEoEX-?---MT--X-BBM-M--------|--M-Bo-?-MToX-EM-E-B----?EX--E|B-?-MoTT-B-BM
B--X--||B|o-----TTEo-E-BB---M-o--|E----E----o?-M|?M-----MT---?T---|?--E|--B?M--E-M|-Mo---M--T--T-MT-MBTM--|T-o-o-ME-B--|-BX-X-TX|-oMM------|?--|-TEBX?-?--X----M-------M?|--------E-T---------|-M--B--XX
--|X---T-T||M|E-X--T-B--|o----|--|-MM--o--BM--X-ETooME--TMM--oX-T--T-T-B|-E----T--oB----oo--o-?E--E?-?TB-|-MX-o---X-T--MTM--B------------|-|--XX---M-BT--------M|--|M-M-o----E|Eo-XBB--|X??-M|E----B---|
m--oMM----|?-E|XXoM------BMM--T-o---o-M-E--?-MTE?--T--EX---o-Boo|?-|-XM-E-MT-o--o-----???T-o-M-----|T|---T-------|MMo|o-?-E?B-X----?X--|---MoEX-?--?X-o-B-XM-EX---XB-E-----|X-MB---------?-MMo-o-BX--XEE
XXXXXXXXXXXXXXXXXXXXXXXXXXXXXXXXXXXXXXXXXXXXXXXXXXXXXXXXXXXXXXXXXXXXXXXXXXXXXXXXXXXXXXXXBXXXXXXXXXXXXXXXXXXXXXXXXXXXXXXXXXXBXXXXXXXXXXXXXTXXXXXXXXXXXXXXXXXXXXXXXXXXXXXXXXXXXXXXXXXXXXXXXXXXXXEXXXXXXXXX
