----------o-------------E-M----o---------X-E--------X-------X----|---E------?o--EB------BB---|-?-------M-----T--------T------EB----E--M------M----T-----o--Mo----B------?----M-----B---X-M--|----B---T--
----T-E------X-E-?-------------------M---o--B|M--E------E-M-B-X--|?X--E-----B--|--o-X-?----o-|-B---M--------o|--------|o-----M-X--o----?---?----To||---||-||-----|?----------?---|--|-|----B|?-X--|--|B-
--o||-|-?----------M---o---o--|-E|---|----||M|---||-----|--|-B---|----|To----TB|---M-E-----|-|-|-|--?-|--M---|-|-o----|?|----T--||---|---|----|o|-||---||-||-EX--||?----------BE||--|-|BE|-||---M-|--||-
-B-||||||||--T-o--T-|-o-||-||-|-||--|||?|-||||---||-?||T|?o|---|E|T---||||---|-||E-?|-|--M?|||-|||----|-B----|-|-E----|o||o|||--||||||-?-||-B-|-|-||-E-||E||M?||-||-|--|M|M||---|||||||-B||||----M|-|||-
-E-||||||||--|--|-|-||--||-||||E||-||||-|-|||||--||-B||||-||--||-||--?||||---|||||o-|-|---||||||||---||--E--||-|----XX||||-||||-||||||||||||-||-||||--||||||--||-||||o-|o|-|||M||||||||--||||o-T--|||||-
--|||||||||--|-||-|-||--||-||||B|||||||||-|||||-|||--||||-|||||||||||X|||||E-|||||--|-|-|-||||||||TX-||-|-B-||-||---|X||||-||||B||||||||||||-||-||||||||||||-T||-||||B||-|-|||||||||||||-|||||E||||||||-
--||||||||||||-||||-|||-||-||||||||||||||||||||-||||X||||||||||||||||||||||--|||||--|-|-|-|||||||||--||-|?|-||-||||-||||||||||||||||||||||||-||-||||||||||||-|||-||||M||-|||||||||||||||-|||||-||||||||-
-||||||||||||||||||-|||-||o||||||||||||||||||||T||||||||||||||||||||||||||||||||||--|o|||-||||||||||-|||||||||-|||||||||||||||||||||||||||||o|||||||||||||||X|||-|||||||||||||||||||||||||||||-||||||||v
-||||||||||||||||||||||-|||||||||||||||||||||||||||||||||||||||||||||||||||||||||||||-|||-||||||||||||||||||||||||||||||||||||||||||||||||||||||||||||||||||o|||||||||||||||||||||||||||||||||B||||||||f
-||||||||||||||||||||||||||||||||||||||||||||||||||||||||||||||||||||||||||||||||||||||||-||||||||||||||||||||||||||||||||||||||||||||||||||||||||||||||||||-|||||||||||||||||||||||||||||||||-||||||||f
-||||||||||||||||||||||||||||||||||||||||||||||||||||||||||||||||||||||||||||||||||||||||-||||||||||||||||||||||||||||||||||||||||||||||||||||||||||||||||||-|||||||||||||||||||||||||||||||||-||||||||f
-|||||||||||||||||||||||||||||||||||||||||||||||||||||||||||||||||||||||||||||||||||||||||||||||||||||||||||||||||||||||||||||||||||||||||||||||||||||||||||M|||||||||||||||||||||||||||||||||-||||||||f
-||||||||||||||||||||||||||||||||||||||||||||||||||||||||||||||||||||||||||||||||||||||||||||||||||||||||||||||||||||||||||||||||||||||||||||||||||||||||||||||||||||||||||||||||||||||||||||||||||||||f
-||||||||||||||||||||||||||||||||||||||||||||||||||||||||||||||||||||||||||||||||||||||||||||||||||||||||||||||||||||||||||||||||||||||||||||||||||||||||||||||||||||||||||||||||||||||||||||||||||||||f
m||||||||||||||||||||||||||||||||||||||||||||||||||||||||||||||||||||||||||||||||||||||||||||||||||||||||||||||||||||||||||||||||||||||||||||||||||||||||||||||||||||||||||||||||||||||||||||||||||||||X
XXXXXXXXXXXXXXXXXXXXXXXXXXXXXXXXXXXXXXXXXXXXXXXXXXXXXXXXXXXXXXXXXXXXXXXX-X-XXXXXXXXXXXXXXXXXXXXXXXXXXXXXXXXXXXXXXXXX-XXXXXXXXXXXX-XXXXXXXX-XXXXXXXXXXXXXXXXXXXXXX-XXXXXXXXXXXXXXXXXXXXXXXXXXXXXXXXXXXXXX
