---------------------------------------------------E---------------------------------------------------------------------------------T------------------------------------------------------------------
--------------------------------------------------------|-------------------T---------?-------------------------o-------------------------------------------------------E-------------------------------
------------o---------------------------------------------------------------------------------------B-------E----------------------T------?-------------------------------------------------------------
-------------------------------------------------------o------------------------------------------?-----------------o---------------------------B-------------------------------------------------B-----
----------------------------------------------------------------------------------------------?------------E-----------------------------------------------------------------------X--------------------
----B-----------------------------------------------------T---------------T-----------------------------------------------------------------------------------------------------------------------------
-------------------------------------------------X--------------------------------------------------------------B---------------------------------------------------------------------------------------
----------------------------|----------------------------------E-------------------------------|-------------------------------------------------------------------------------------------------------v
-----------------|---------------------------------?---------------------------------------------------------------------------------------------------------------------------------------------------f
-----?-------------------------------------------------------------------------------------------T----------X----------?---X-B-------------------------------------------------------------------------f
---------------------------------B--------------------------------------------E-|----------------------------------------------------------------------------------|---------------------------E-------f
-------------------------------------------------------?----o----------------------------------------------------?------------o------------------------------------------------------------------------f
---------------------------------------------------------------------------------------------------------------------T-B------------------------------------------------|------------------------------f
-----------------------------------------------------------------------------------M---------------M-----------------------------------------------------------------------------------------------M---f
m---------------------------------------------------------------------------------------------------------|--------------------------------------?-------------------------------------B-------X-------X
XXXXXXXXXXXXXXXXXXXXXXXXXXXXXXXXX|XXXXXXXXXXXXXXXXXXXXXXXXXXXXXXXXXXXXXXXXXXXXXXXXXXXXXXXXXXXXXXXXXXXXXXXXXXXXXXXXXXXXXXXXXXXXXXXXXXXXXXXXXXXXXXXXXXXXXXXXXXXXXXXXXXXXXXXXXXXXXXXXXXoXXXXX?XXXXXXXTXXXXX
