--------------------------------------------------------------------------------------------------------------------------------------------------------------------------------------------------------
---------------------------------------------------T--------X-----------------------------B---------------------------------|----------------------------------------------------------------B----------
----------------------o---------------------------------------------------------------E---------------------------------------------------------------------------|-------------------------------------
---------------------------------------------------------------------------------------------------------------------------------------T----------------------------------------------------------------
---------------------------------------------------------------------------------------------------------------B------------------------------------------M---------------------------------------------
---------------------------------------------o------------------------B-----------------------------|-------------?---------------------|---------o--------------------------------------E--------------
---------------------------------------------------------------------------------B------------------------------------------------?------------------E---------------|----------------------------------
-------------------------E-------------------------T-----------------?---------------------------------------------------------------------------------------------?---------------------------?-------v
-------------------------X-------------------X--------X----------------|-----------M-------------------X----------M-----E------------------------------------------------------------o-----------------f
-------------------------------|----------------------------------------------------------E-X--------------B---------------------T--------------------------------------------------T------------------f
---------------------------------------------------------------------------------?---|---T--------------E----------------------------------------------------------------------------------------------f
--------------------------B---------------E-------------B------------------------X-------------------------------B--E------|--------------------------------------B-----------------------T------------f
----------------------------------------------------------?--------------------T-----------?--------o--------------------------------------------------------------------------------------------------f
----------------------------------------------------T-------------------------X---|--------------------------------------------------------------------------------------------------------------------f
m---T--------------------------------?-----------------------------------------------------------------------------------------------------------------------------------------------------------------X
XXXXXXXXXXXXXXXXXXXXXTXXXXXXXXXXXXXXXXXXXXXXXXXXXXXXXXXXXXXXXXXXXXXXXXXXXXXXXXXXXXXXXXXXXXXXXXXXXXXXXXXXXXXXXXXXXXXXXXXXXXXXXXXXoX?XXXXXXXXXXXXXXXXXXXX-XXXXXXXXXXXXXXXXXXXXXXXXXXXXXXXXXXXXXXXXXXXXXXXX
