-oTo-----E-o-------M-----|-----E------ET-------------M-?--B-M------o-XB---B----|---X|-|-------T---?--?-o--ToX-E---B---T-----oB---T?------X||-X-----B----------------?----EB--------T-?o-----ME-|-|--ET--
-------B-------------X---M?------oEX---o---|---E-------?------X-----B----M-------X----------E-o---M-------T|----M---M--T------E-|---|--o---------M-T-------?---?--X-TX-B---M---E--ET-----E----E------?--
-X-Eo--------M-?E----X------------X-----B-E---X-?-X|-?M?-------X----B--o---o-----?-E-BEE-X--|-o--M-----?-|E--------??----------------T-----|-XE-------?--o------E------B---------B-o--|---oET-----X-E---
-------M-E-X-?------B-||---------------o--ToE----------?-T--X-o-----E---o--o------------------|--M--?--------E|E-o-------E----T---||-------M---------E|----T----------M----o-TT------M-X---oT---BB-|--E-
---------oM---X-----T----M--ME--??-----T--M|-----------E--------B------T------TM-?-E---------------------o----------------?E------|o---BB-|--------o-M---?-----M----X---T-E-B----TM--E-----|--------|M--
------B-?--o-|--------------M--M--M-------E----?-----X--X-----T----------X-?-----X--------------X|---E?-------T-----X--M-?--------|-??--o------B--o-----X---------------T-----------BE-o-------|-----BE-
--o--o------E--o-o---o----|---B-E-o--|-------|-------------oT-|?--T---B-------B--E-?-T---M--|X-?B---|------E---B--------B-----|--o--M-B-|-----T---B------B------o-----?----B-------------XT--|-----?-M--
-----T----BM-EXT-----M---|---?-T----E-M---o-----------B-|-------E--E---------E------T--o--M----------E------------M|-E------X-T-?---B-----BB-oX|o---------M------?-B---X|-B|o---T|----------X----------v
----------B---E------T---X-E-|TE-T--T--------------T---------------o---TE--M--|X-----B-?---M------------E---?M--T---?----B---?-|-----T--X-EoB----?----M-E-----o-o----XM---|--|-E----|----T----------E--f
------M?-----|X--MX--o----M--------M--E-?---------T--E-o----------B-XM----------------------EXB------X-T------oET--BX----o-M-------E--EoB-------|------B----oX-oE--TEEM----B-------o-E?---E-B---|----B-f
-------B---|-B---M------|--?------MM--------o---o-----T------M-----o-?-----M---------B-B----?-|---?----|------XoM---M-----MB--o---T-T----o----T?---|T-B------ME-o-|--T----X-B--------------|--X--BM-o--f
----T-------?EX--o--To--?||M--?X-?----------EX-------ME-?-------------T-M--EM--E?-------E-----------------T------EoB--M|---?---B-----------?T--M||---------------?-----|-?-T|--MEM?-----T?-X-?B---o|---f
---------------B-----------M-TX---|--EB----T---?----B----------o??o---|----o---o---EE--T-----?------------B----To----X--EM--?----X---------?--XBB---oB-B-----------------oE--XE|?E-o-----EB----M----oE-f
------B---E----E----E----M-E--B---E-M--|--T-|?---E-----?T|-o----|X--------------o-------o--X------TX?B--M---B-MM-?X----B-M--B---?--B-|--E-?------E-----M------------o---------M-X------T-E--MBM---?--E-f
mB-oX-Xoo--T----E-B----M---------M-M-?------B--M?------|X--o?--oE--B--|?|-----|-T---M--BT------------Mo----M--E------?-------XB----------o?-------X---|---|--B---------?-----------------E----B---XoMo-X
XXXXXXXXXXXXXXXXXXXXXXXXXXXXXXXXXXXXXXXXXXXXXXXXXXXXXXXXXXXXXXXXXXXXXXXXXXXXXXXXXXXXXXXXXXXXXXXXXXoXXXXXXXXXXXXXXXXXXoXXXXXXXXXXXXXXXXX?XXXXXXXXXXXXXXXXXXXXXXXXXXXXXXXXXXXXXXXXXXXXXXXXXXXXXXXXXXXXXXXX
