------------------------------------------------------------------------------------------------------------------------------------------------------M-------------------------------------------------
--------------------------------------------------------------------------------------------------------------o--------------------------------o--------------------------------------------------------
------------------------------------------------------------------------------------------------------------------------------------------------------------------------------------------------B-------
--------------------------------------------------------------------------------------------------------------------------------------------------------------------------------------------------------
---------------------------------------------------------------------XXXXXXXX---------------------------------------------------------------------------------o-----------------------------------------
---------------------------------------------------------------------------------------XXXX-----------------------------------------------------------------------B-------------------------------------
---------------------------------------------------------------------------------------------------?------------------------o---------------------------------------------------------------------------
----------------------------------------------------------------------------B-----------------?-------------------XX-------------------?????-------------------B---------------------------------------v
---------------------------------------------------------------------------------------------------------------M------------------------------------------------------------T--------------------------f
------------------------------------------X------------------------------------------------------------------------------X--------------------------------------------?-----|--------------------------f
--T--------------------------------------XX----------------------------------------X-----?------------------------------XX----------M-------------------------T-------------|------o-------------------f
--|-------------------------------------XXX---------------------------------------XX-----------------------------------XXX----?--B-----------X----------?????-|-------------|--------------------------f
--|------------------------------------XXXX--------------------------------------XXX------------------------------Mo--XXXX-----------------XXXXX--------------|-------------|--------------------------f
--|-----------------------------------XXXXX-------------------------------------XXXX---------------------------------XXXXX------------------------------------|-------------|--------------------------f
m-|----------------------------------XXXXXX-------E----------------------------XXXXX----E-----------E---------------XXXXXX----------?-------------------------|------------E|-E-M--------------E-------X
XX|XXXXXXXXXXXXXXXXXXXXXXXXXXXXXXXXXXXXXXXXXXXX------XXXXXXXXXXXXXXXXXXXXXXXXXXXXXXXXXXXXoXXXXXX------X-XXXXXXXXXXXXXXXXXX-----XXXXXXXXXXXXXXXX------XXXXXX---|--XXXXXXXXXXX|XXXXXX--XXXXXXXXXXXXXXXXXXX
