---E------MTBB---------o-E?MoE----o----?E---o--E---T---??EX----?-----M----?--BBo-----B-?----T---?--X-----------o-----------MBX----E-----M-----------B----M?-o------||-|-------M-TEBB?ME-|---X?--------X-
-|M-oM-M---o---|---B-B----X-|----M-o--|-o--|B-M----?-?---E----MTX---X-|-E--X----EM--M---M-?---T---EMT|X----XTE--B-EX|-------|--M-BE--E-X-------T--o|E------B--|--M-To-T-----------|---|---?----B--|--|--
-EEoX-?--M-|B--|o---|---Mo--BX-----------X--|T-MM--E--?-BXME--------|-----E?X---E-|----?-M----M-B?--T---?------|-------X---o--M-oo----o--X-----MBT--BX-o-----B---T-E--X---M--o------E-----M--?-ME---B---
----T----X-T----T?---M?o-?-------BE?--E|---M---------|E-?-M-o-E-------------M--E-?---EoX?-?Eo-o----E?---X----|-----X------o------T-?------MX---T-----?-|-|-----X---o-------TX--B|T--B-X----XT|------o---
-----EXoM--o-o----Mo---------X-M------M-EX--B------|---BoE---|TTTX--?X---X--|-----X----o------oBM-E--E------T------?--o|---------o-|----T-T--------o-?---E----?--------E------X---oXTo-----MM-------|---
---B-B-M----E-E---o------M-oM------T----TX------|XB---MB-----T----o--X-B-----M-X-|---X--------B-----MT-M--o-X-XX-----M-Mo-oT---E|B--|E-M?X---X--MM|BX?-|----|---??E--BMTB---o?-|---TB-------E-----X---|-
-----o--B--X?---E|T-M---o--E-?--B---o-X-BM--E-----------T-----X-X------o--X|------X--o--M----|-oB------o--o-X-B?--?---Eo-o-?-BB--|----E-----oBBEE-T--o----------|-T-B-M-X-M--------B-|X---o------?-BX---
---o--EoXE-T--X----------E----EX-B--|-|-------?-T-X-----X--B-M-X-TBMMM----?-T-----BX-----B-----X----------?------BT----X-M-----|------o-?--B--E-M--EM-X--E--T-B--o-o---?----E-------M|----B-M-|T-o---Xov
---o-MoETo------|-o------oT----?-----B-B----B------T-?---o--M---B-XE-----E----TM-------------------------M---X-----X-?---B-----M---E--?||--E-|?EM----M-B?M-?-?----T-|--B---X----E-|X-o------E|To---?---f
---|-B-?TB--------T?--TB--|X--o----M-TX----M--?|?----oB|------oE|--M--|-----|o--XM-XM-----B--E----?M--T----------B------E--------MM---ME--Bo-TB-E--X-----M---MM-o|-?--E|--------B-?X--M---B----?o----X-f
-----BB--E----T-M-T-----BMBXX--X?--E--oB-X-------------BM-----E----T|---------?oT--B--------B-oM-------E--E--o--E--?--T----TE---|-B-?|MX----o--??o-T----T--M--oE---o--?To----B-----BM-------E---XE-B---f
-o-E-----E-o-|oXo----o---------oT---MEB---B---|-E--XB---B-E----M--TT-T--X---------------T-M-BE-?-----oB--oTE-B?----EEB---B-----M---------o-----M--B-?----B--X----|--T----o-o|-E-MoT--?XB-----Xo--M--M|-f
---|---T---o-B-?|oM----|-B-|----T?--M--E--------T----------XoM-----?-BMEE---o?M------EB-|-----?-M--|X-?-M----------T-E?|-BT---EE----E----X---EX------------T----BE----T-----M|-------T??---|X-M-?T-MM?|f
---B------B--------B-------------B-M---X-X----?-----B--XE----E?----T-T---M--------XT??-|------T---?Bo----E--|?-E?|-X-MET??---|--B------|--E---|o------E?oB--E--o--M---o-o-----B--T--------T--XT-|---T--f
m--------T------X---o-M-B--T---|-B---M-o-----------M----T----------B-E-----EX-X---|-T-X-oo------?--E|-|---XB---X|o-?--MTM--E---T||?---?------E-o-B-------T--T-----X--Bo---MB----X-----?--MXM-X---X----TX
XXXXXXXXXXXXXXXXXXXXXXXXXXXXXXXXXXXXXXXXXXXXXXXXXXXXXXXXXXXXXXXXXXXXXXXXX?XXXXXXXXXX-XXXEXXXXXXXXXXXXXXXXXXXXXXXXXXXXXXXXXXXXXXXXXXXXEXXXXXXXXXXXXXXXXXXXXXXXXXXXXXXXXXXXXXMXXXXXXXXMXXXXXXXXXXX-XXXXX-X
