-----|------?-------X---T--o?|-------?------X?-------?---?X-|E------M--------oB--o---|----M---|--M------?---ET---M--oB-?----T-?-?-------B------XM--M---------E--X---B--T----MMEE----------o-B----TET-M--
----------------?T---BX-------X---XoE---|Xo----B-o----?-XTTT---E--|---X---T--T----?---------o-----X---------------TX-----B-E-X-X-|----------T-------X---o------EE-M--?--EM------------B-o|X-----To-?----
---------o---X|o----|T-E?--B--E----o-M-B-----M--B-----?-X-----------X--------Eo---o----?-------------M---------?-EX---------X---TB-?--|X---|---|------M--o-X--MX-?-|Mo---?-?|----oX|---X-o--To--X-------
-X------E-----E--o--E--Mo|---M--X|-B-----MX---------M--B--T--X------------?--E-E-B-|X---T-E--B---B--o-?--o-|--------M-o-EE---EXoE-------------?---------M---o-----T------?-M---X--TX----|-METB-------|--
----------M---|EM-M--ToM--XX-------------B-oo-E-----M?--|-------M----XX-E--M--oX-----M-----X-----BB--?-T---Bo---------------o-----M----------E---o----E-?-|--o--------B---M-X|---------o--M-o------M--M-
--B---E?MX-o---?---T?---B---------E?---------------X-B----M--?---||?-----B-E|-X--o--M-----EB----------?To------T-o--X---X--X--MXEoX-M----o-M-------T-o--E?-o--?-T-o-----X----------------?-?---B---M----
--BoM----|----oTM-------?M--o-|-----------X-------XE-----?EE---B----------------B--B-BoE|--------------X--------------M--B--------?--M-----|---------X----E-T-|-----B----------o----T-?-----M----XT--M--
-?----ME-E-TX-X--X-MT-----------X-|-----o----E--BE--X----?-------EE---BE--------T----X-?|T-o----------||----o--??---M-------M--------?-----Eo---------------oB-----X-?o-------------------o--o---------v
--M------E-----T----T|------M------T-----------X---o-TM-E--oE?----------M------?-M----|--|----E----M--o-E|o-----------B-----EBX--o----B-|?---T-T--------|-ME---B--M-------B-B-------|---|XB---E?------Tf
--E-o------T-Mo---o-E----M------oE-----B--EM-T--?---MX------M----------o-M----T---------o|E-T-TX--EM?-------|MME---o-M---------o|-----B?-----E|-?E-B------------M-o----------E--?---E--o---EBT---------f
-M-MX---MXX------X------B--o?-----------|---oBM----X-------------------XEX-o--|Xo-B-B----o-----EB--------|--M-X-------------?-ETT-M-|?-----|------B----M--B----M?---?---Xo|EX---M--o--?T---------------f
---E?--E---X--|---------E---------oB----Mo---|--|-M--B--o-o?---EB------?-B---o?-E-?M-T--oo----B?------BE------?-----X-------To--B-------oB---M|---M----X-o--|E-oT-EE-------?M--|-----T-?------T----E--Mf
------?------o-E-M-M-X--E----?-X?--|T--E-T---X-oo--M------?----|------B---------E---------T--M-----MoXM----M----?-o----M-|E-------M--?---B-T--E|---MX-T----M--M----E--?T-X---BX------------oE---B-|-X--f
--o--XB-T----M--------?------T-------------M-?----E------BoE-o----E-?------E-----E-E-|B---|------T-----------------M-o----oXB--B-------BM----B----------?--------TE--X---M----T-XTE-----B--E--?---M----f
m---M-----o--|-E--X-?-?--X-T----MXE--MM-----------------B---XX---|TEM-M-B-?--B-----|?T-----?--B---E--E-M---B|BT--?M--BM--MoT-X-----?-|o--M-T-E-X-M-?--T-B-X--T-E-----M-------|-M-T----TEX-----|--T---EBX
XXXXXXXXXXXXXXXXXXXXXXXXXXXXXXXXXXXXXXXXXXXXXXXXXXXXXXXXXXXXXXXXXXXXXXX-XXXXXXXXXXXXXXXXXXXXXXXXXXXXXXXXXXXXXXXXXXEXXXXXXXXXXXXXXXXXXXXXXXXXXXXXXXXXXXXXXXXXXXXXXXXXXXXoXXXXXXXXXBXXXXXXMXXXXXXXXX-XXX-X
