--------------------------------------------------------------------------------------------------------------------------------------------------------------------------------------------------------
--------------------------------------------------------------------------------------------------------------------------------------------------------------------------------------------?---?-------
---------------------------------------------------------------------------------------------------------------o----------------------------------------------------------------------------------------
-----------------------------------------------M------------------------------------------------------------------------------------------------------X-------------------------------------------------
-X--------------------------------------------------X------X-----BBBB---T--------------------------o-----------------------------------XXXX--X----------------------------------------------------------
-------B-------------------------------------------XX-------------------|-------------------------------------------------------------------XX----------------------------------------------------------
-----------------------------------------------T--XXX-------------------|------------------------------------------------------------------XXX--------------------------o-------------------------------
-----------------------------------------------|-XXXX-------------------|------------------------------------------------X----------------XXXX---------------------------------------------------------v
-----------------------------------------------|XXXXX-------------------|-----------------------------------------------XX---------------XXXXX----------------------------------T----------------------f
-----------------------------------------------|XXXXX-------------------|----------------------X-----------------------XXX--------------XXXXXX----------------------------------|----------------------f
----------------------------------------------X|XXXXX-------------------|-------------------------------o-------------XXXX-------------XXXXXXX----------------------------------|----------------------f
------------------o--------------------------XX|XXXXX-------------------|-X--------T---------------------------------XXXXX------------XXXXXXXX---------------------------------X|----------------------f
------------------------------X-------------XXX|XXXXX-------------------|----------|--------------------------------XXXXXX-----------XXXXXXXXX----------------o-----------------|----------------------f
------------------------------XX-----------XXXX|XXXXX-------------------|----------|-----o-------------------------XXXXXXX----------XXXXXXXXXX----------------------------------|----------------------f
m-------E---------------------XXX---------XXXXX|XXXXX--E----------------|----------|---------------E--------------XXXXXXXX-E-------XXXXXXXXXXXE--------E------------------------|----------------------X
X---XXXX????XXXXXXXXXXXXXXXXXXXXXXXXXXXXXXXXXXX|XXXXX-XXXX-----XXXXXXXXX|XXXXXXXXXX|XXXXXXXXXXXXXXXXX------XXXXXXXXXXXXXXXXXoXXXXXXXXXXXXXXXXXXXXXXXXXXXXXXXXXXXXXXXXXXXXXXXXXXX|XXXXXXXXXXXXXXXXXXXXXXX
