----------------------------------------------------------------------------------------------------------------------------------------------XXXX------------------------------------------------------
--------------------------------------------------------------------------------------------------------------------------------------------------------------------------------------------------------
---------------------------------------------------------------------------------------------------------------o----------------------------------------------------------------------------------------
---------------------------------------------------------------------------------------------------------------------B----------------------------------------------------------------------------------
---------------------??---X-------------------------------------------------o--o------------------X-----------------------------------------------------------------------------------------------------
-------------------B-----XX----------------------------------------------------------------------XX---------------------------------------------------------------------------------------o-------------
------------------------XXX---------------------------------------------------------------------XXX-------------------------------------------------T--------------------X--------T---------------------
-----------------------XXXX-------------------------------------------------------o------------XXXX-------------------------------------------------|-------------------XX--------|--------------------v
----------------------XXXXX-------------------------------------------------------------------XXXXX-------------------------------------------------|------------------XXX--------|--------------------f
---------------------XXXXXX-----------------------------------------------------X------?-----XXXXXX---------------------------XX--------------------|-----------------XXXX--------|--------------------f
--------------------XXXXXXX-----------------------------------------------------------------XXXXXXX------------------------------------------------T|------------X---XXXXX--------|-----T-----------X--f
-------------------XXXXXXXX----------------------------------------------------------------XXXXXXXX-----------------o--------T------------T--------||---------------XXXXXX--------|-----|----------XX--f
------------------XXXXXXXXX-------------------M-------------------------------------------XXXXXXXXX--------------------------|------------|--------||--------------XXXXXXX--------|----B|XBB------XXX--f
-----------------XXXXXXXXXX---------------------M--X-------------------------X-----------XXXXXXXXXX--------------------------|------------|--------||-------------XXXXXXXX--------|-----|X-------XXXX--f
m---------------XXXXXXXXXXX-------------------------------------------------------------XXXXXXXXXXX--------------------------|------------|--------||------------XXXXXXXXX--------|----X|X------XXXXX--X
XXXXXXXXXXXXXXXXXXXXXXXXXXXXXXXXXXXXXXXXXXXXXXXXXXXXXXXXXXXXXXXXXXXXXXXXXXXXXXXXXXXXXXXXXXXXXXXXXXXXXXXXXXXXXXXXXXXXXXXXXXXXX|XXXXXXXXXXXX|XXXXXXXX||XXXXXXXXXXXXXXXXXXXXXXXXXXXXX|XXXXX|XXXXXXXXXXXXXXX
