-MBMB|B|?|o?oXEMM|?BBTETo?-?|XEoBMoX-MoT-?ToT|-oE|BBMTET?-||B|Bo|MXXBE--??|oBoXBTX-TT|M?BXMXM-BX|-EEEBX-BXBMBXo-||M|?-MM-MM|||XM??|--TBXo-XE-B--o|EoBMTo||?|?M-ME--Mo?-E?E-T?BMMTo|B-EoBXEBBTEB?E?--ETEM
ooM?X|o|B||-E|BT-|EoT|T||||-|Mo--|B|?TM|XT|-||T-?|B-T|-||B||o|BE|o--|?M||o|B||X-||||||BM|BMM|oTM|-TXX-M?M|T|X-Eo||o|||XBoE|||||BM-|T|||X|BMBMT|-E|M||o|E||||XE?|EToBM-o-?B?|T|||||||B|ETE-TE|M|XTTX-||-B
?E||?|||-||?-|X|X|T||||||||||oMM?|||||B|M|||||||B||?||-||-||B|BB|o|||-|||||X||||||||||ET|-|||||-|E||o-||||||X?|X||M|||||?E|||||EEE||||||||-B||||M||||X||||||o|||-|XE|?|||B?|||||||||X|X|o||?|||B||-||||B
EE||||||-|||B|||o||||||||||||XM|||||||T|||||||||||||||B||o||-|X||B||||||||||||||||||||o||||||||-||||M|||||||||||||-||||||||||||B|||||||||||o|||||||||T||||||E|||o||B|||||?E|||||||||B|E|o|||||||||M||||?
X-||||||T|||||||||||||||||||||E|||||||||||||||||||||||||||||||?||-||||||||||||||||||||-||||||||M|||||||||||||||||||||||||||||||o|||||||||||T||||||||||||||||||||?||X||||||||||||||||||M|||||||||||B||||B
o||||||||||||||||||||||||||||||||||||||||||||||||||||||||||||||||||||||||||||||||||||||||||||||||||||||||||||||||||||||||||||||X|||||||||||||||||||||||||||||||||||?|||||||||||||||||||||||||||||||||||X
X||||||||||||||||||||||||||||||||||||||||||||||||||||||||||||||||||||||||||||||||||||||||||||||||||||||||||||||||||||||||||||||||||||||||||||||||||||||||||||||||||||||||||||||||||||||||||||||||||||||E
B||||||||||||||||||||||||||||||||||||||||||||||||||||||||||||||||||||||||||||||||||||||||||||||||||||||||||||||||||||||||||||||||||||||||||||||||||||||||||||||||||||||||||||||||||||||||||||||||||||||v
E||||||||||||||||||||||||||||||||||||||||||||||||||||||||||||||||||||||||||||||||||||||||||||||||||||||||||||||||||||||||||||||||||||||||||||||||||||||||||||||||||||||||||||||||||||||||||||||||||||||T
T||||||||||||||||||||||||||||||||||||||||||||||||||||||||||||||||||||||||||||||||||||||||||||||||||||||||||||||||||||||||||||||||||||||||||||||||||||||||||||||||||||||||||||||||||||||||||||||||||||||X
?||||||||||||||||||||||||||||||||||||||||||||||||||||||||||||||||||||||||||||||||||||||||||||||||||||||||||||||||||||||||||||||||||||||||||||||||||||||||||||||||||||||||||||||||||||||||||||||||||||||E
B||||||||||||||||||||||||||||||||||||||||||||||||||||||||||||||||||||||||||||||||||||||||||||||||||||||||||||||||||||||||||||||||||||||||||||||||||||||||||||||||||||||||||||||||||||||||||||||||||||||-
o||||||||||||||||||||||||||||||||||||||||||||||||||||||||||||||||||||||||||||||||||||||||||||||||||||||||||||||||||||||||||||||||||||||||||||||||||||||||||||||||||||||||||||||||||||||||||||||||||||||?
X||||||||||||||||||||||||||||||||||||||||||||||||||||||||||||||||||||||||||||||||||||||||||||||||||||||||||||||||||||||||||||||||||||||||||||||||||||||||||||||||||||||||||||||||||||||||||||||||||||||?
m||||||||||||||||||||||||||||||||||||||||||||||||||||||||||||||||||||||||||||||||||||||||||||||||||||||||||||||||||||||||||||||||||||||||||||||||||||||||||||||||||||||||||||||||||||||||||||||||||||||M
XXXXXXXXXXXXXXXXXXXXXXXXXXXXXXXXXXXXXXXXXXXXXXXXXXXXXXXXXXXXXXXXXXXXXXXXXXXXXXXXXXXXXXXXXXXXXXXXXXXXXXXXXXXXXXXXXXXXXXXXXXXXXXXXXXXXXXXXXXXXXXXXXXXXXXXXXXXXXXXXXXXXXXXXXXXXXXXXXXXXXXXXXXXXXXXXXXXXXXXX
