-B-X-E----B-M--T-------------BE--?-----T----|o--B|-------B--X-----X---TX---E----------M----Bo---TB-ME-M------||o--B-----M------E-X-----X------M------E-------?XB--------o-|-E------B----E-E--E-?----E-B-
-------o--E---o--MB----o--o---X--------o--?--oB|--EX----E-------o---E---E-M-----------M-----X------?o------T---------X-X--------E---E----TB?-o-----B-----M-o---M--|-----------M-----|----------?o-M-----
---E-------M--T--M---o--ETT-E-E----------?-----------X---X---------E------------E---MB---------o-----|----X?-T|---M----E-----X----oBB-T----------|-X----EB---B---------------E--B--------E----?o--oB----
-B----XB--------EoXE---E---E-|E?----?----|-B--T-T-E--o-------o----E--o|E--------|------------?-----o---o-M------|o-T--TM-?-B----o----M--o----oX-?-------|-??M-----X---------E-B------?---o------|o------
--B----?--TET-X---|---?-------------BXX--------|--T--?--M----------|----|E-M-oT?-E----------------------B|--M-Eo|X-E-M-oT-----------o-T--X--E---T|-----T-|---|-----TM---o-M----------M-------M---B-?-B--
---------o----M|---------------MX---------|--M--E-|-----oB--X----M--------T--T-----B?-----B------E----M--E-|------?-----ET---|T-B-|--o----X----o--?oo--E---------o--T-------E----M-----?---X--B-E--B-?--
--?-?-----------------T?-T-|MBoX--M---E---------------o---o----------|E------EE-----?--------B--------|-----BE--------------?X-----XE---E---------|--------X-?---T--MoM-E---?X-----|-------E------------
---B--XM?XE--------EMM-------o---|------B--|---o------TB--EB-------E---------T--o-----------X-o--------MM-T--|-o------|-----X-o-M----M---M-----o----E--------|----X--------E--|?B---E----|--------X----v
-------|---o?-----o-M----X-B----?-------X-----M--?-T-|---oB---T--o---BX---------------E-TX----E-|--------------T----------M?--E----E----M?--X--?X----|------o-?M----T-----?o|-BE-B-M?X------Mo-T----T--f
---E-------XM--------M----EB----------|-B------M-----T----|-------?--?o---------T-E--|--?-----M---?------T-X-M|---E-?---------?-M-?---EB-B-o------T--------B--o----------BX----B------|------M-----T---f
---------------|---?-T-oX---Eo----T--------|-----------T--?-M-o--oXXE---M--T|--T-|----oXM-----XX-M-------?B----T-B-|-?|-X----|-------o-|-B-B-B------?----o-T---------T----X-M-----|-|-TT----|T--oM-B--Tf
-?----|--|-------T---------T------X---B-----------B-?M--MT------o-----oB-----E-------E----?X--?--B---------XX-B------BoM----------?oE-------------EMB-o---|?B--B?---M----------?--E---M----T---------M?f
------------?------X---M---o------X---|-------|---B-----TT------?--E--|B-M-M-|--------------M?B---|-ET----E?TX?---------o----B-?--B---B--o-------X-?-------X--B-Xo------|-----XE--o---?-|--T---E---Xo-|f
-----E--X------|M----E-E-XB------E-------T------M?---M-------T-|--B---------?---------??--------E-E-----M-|M--B------M--X|--M--?--|B-o----T----M--|---B--E-----------B-|-|--oB-E-----------o-M-------?-f
m--------------TT----|E----B-?---M----|--------------M-o-------------|---------E-X-?-----X--X-----B----BMX--T--o----o--o--XX--?----?-T-X-o---Bo---o------|-|-------M-?M-?B-|-T---B-|---B-?----------X--X
XXXXXXXXXXXXXXXXXXXXXXMXXXXXXXXXXXXXXXXXXXXXXXXXTXXXXXXXXXXXXXXXXXXXXXXXoXXXXXXXXXXXXXXXXXXXXXXXXXXXXXXXX-XXXXXXXXXXXXXXXXXXXXXXXXXXXXXXXXXXXXXXXX-XXXXXXXXXXXXXXXXXXXXXXXXXXXXXXXXXXXXXXXXXXXXXXXXXXXXX
