-o----T?EBT--M----------|--??-----XEB--o---------------E?--M---M-?---?-B--XX-?-----------?-----------------??-?-------------------E---?----B--------M------M----M-----------------X---------------------
------M-o-|-------------X-X--BBE--o-----?----E--M----B-----------------M-o---------X-----?X--------------M---?------------?ETM---M-M----E---------------X----B---------?---E---oM-----M--M-------B----o-
--E-------M---E?---MT-------?---oo--E-B--o----B--M-X-------o-------B------B-----------o--?-------T---M-------------M--------X--------ME--X--?---?-------------M--------------------------X--B---X-----?-
--------------------XM-----?--X-----o---T----------E--------?-----?T---------M-----------T-------|-?-M---------------M--------o------------------?M-XM---------E----------T-----E--------?--?---?-------
---?--X-o-----MM-----??-------E-E---X---X------?------------------?X-M---------T--------B?-----E?M-------o---?------XB---B-?--?----?--E---------X--M---B----------X-?-----BB--?-----o----?----------o---
------------B--o------M------M-------T-?-B------------T----B-------M-----------?--------------TB-E---?-X---------------o----o----------?B--X------T----------EB------o-----M------------T-----------?---
----X---?-XE-----o-X-----------------M------EE-----o--?-----X-----E-------B----X-o-?-------oME?----------X--------E----------------?--------------M----------?--X---BX--------E-------o-M-----XE--E-----
--BM-X-?-------E-----X-----E--T---X---B--------------o--o------------M-?---X--X-M--------M--E---X---------M--?-------o---------------X----------T-----B---M------------------o?M----B----E-B---BB-----Xv
--oo----M---------------------X-E------B-----T--X-o-o--X--------?------X--B-------------------EX-------------------?o---?-------M-o-----------EBB-----------M--E--------E-E----T--?-oM----M---oTX---M--f
-EX---T----------o-----?---X----T-E------M---B------EE-----------------ME---oM---M----?---?-Mo---------------------------------T--------------E-E---X-------M----oo-E-MB?-oo---B-?----o-----?--M---?---f
---E--M------X----T--o----------X-B--------X-----?-------E---------------E---o---?--------M---T-------------?--?-------------E-M-----B-----------------------T-B----X-----M------------T--Bo-----B-----f
---------------E--MB--E-------------------M-?--?---------?----?-------o-------o-B--X----?---B-B----X-?--X----Eo--------------o----M----------E--B--E---X-----X--E-------------T------E-B----BM---X----Ef
-----B-T----?--------------------------------------oT------M-----X----------E--------E------------------X-------M------------------M-------M-To---------------o--o-?X-o-------X----o--T-------------M-Mf
-----E-|---o----T-----XE---B------B---MM-B-T--------?-??-BX-----X-------------------B--------------?-----------?---X---?-B-oT-----X----------B------E?---------o-M----?--?------M-----X----?-----------f
m-TX---?---M--M-B------X-E-----X--T--------X-X-B-T--T--M--M-----B---XX-X-Mo-----T-E----T--?---B---o-TT---o---M-----------M-BX---------?------------X-B-------------T-----B-----X-ME------B---B-o-B---X-X
XXXXXXXXXXXXXXXXXXXXXXXXXXXXXXXXXXXXXXXXXXXXXXXXXXXXXXXXXXXXXXXXXXXXXXXXXXXXXXXXXXXXXXXXXXXXXXXXXXXXXXXXXXXXXXXXXXXXXXXXXXXXXXXXXXXXXXXXXXXXXXXXXXXX-XXXXXXXXXXXXXXXXXXXXXXXXXXXXXXXXXXXXXXXXXXXX-XX-XXX
