------|----oBEB-?E-B--X--TE--X--X--T--|T----M---||-oB?---o--o---??----o---|XT?--|ETo??-?-MM---EX--T?--------B-------EX--B---o-?-?EBT--|B-E-XME-E--|o-B-E-XM-?|B--E-B|---MTE||-EEM-XT---Eo------|--M--X--
---E-|ME----TM-?BE--|--X|---MB----X---E--T-----B-EM-E---B------EM--M-TM---M---E--M-|MX-?-|-MoE-----B--B?MT--XTX-X-BT-------?E-BB-M--Mo--BM--o-To?--B---M---oMBBoT------TB---TB---T---MX-E--M|-E----B-|?-
-B-B------B?M-------X----B|-B--o----E----?-X--MM|oM-o-T--?-?-E----o------BX----M--------MT--Mo-Bo-------|--Mo-o-BBBB----B-o-XT----|-|XX----XB-----X----o-E-B---|??|--B-||EX----|-o-X--oo----o------X----
-----TX---Eo?-X-|-T-?-?-B---X------EX-TM--o?X-?X-XB|-T-oo-?|B-oXET----E-E--MMXX---------T--BX-E|?BXM-|o-----o--E----E-XB-X-X---|---?-T-o--M--E-EX--T-------B--?---M--E-MT---o-X---B-M?oo-E---EMoo-o--E--
-?X--B?-B|T--o-o-E-M-?X---MEX-oXX--X?-----BE|-M--o--B------E---------E-?---ToE--|-XEE----T-----|X-M-------?---M?--?EM-B---M-|ME--EXM?E---|-EB||Eo-E-M-BB---TT-M---------MT--XTT-ooM-|-T-E-TM-|?-M-ET|M--
-B-B----?T---M?--o--E|B|X-E--BMBo-MX-T-?X-X---E-??-B--T---?|?BX-XX--T-XoE?o---M---B-M-XB--E--XX-oB-E-M-||o-|?XT--T-?--X-E----T--T?o-TM|-E----o-|--B---?-?E-o--X|T--X---M-T----M?EBT-|-B-----|-----T--|--
-M-?|E|oX----EX?-BB-o-T-X---oo?-TEEX--XT--XBE---|--|--X-?M-|?E---M-T---?-oX---o---B--|-XM?---E|--|EB--XM------o|--E|--ToEM?E-----MoE-B-|-X--------B-?--E|--|--B------B--EX--|-?--M-MB--?--B---M--E-MX---
--X-|-To|EEBX-B--?--|-|MBE---M-To-oM-MM--X--|--E---XM-?M|??T---|B-E--T-----o--M?--T-XE-X-B-?--T-?-EX-M-X-|o---M|-|?--XT|---o---Bo--E---TT---?-----T|B-B-E-EE--|-M?--B--B--?-MoXT-E---B-oX-----B-?-M-B-Tv
-EXBX-BT--B---o-M?--E----o--?M||---X-|--|-M---XTE-----?-X|--Bo|M--?E-M---oBoo--XT??----|-E-T?-B?-?T?-E-XE---X-----EMTE-?-EX|M-B|-|-----M?-XTEM----E-B--?-M-?T-T|X|oMB--X----B-|-?|-----B--B--E-M---MM-of
---E--?--M----TX------B-o---oE||-Mo---|--X-X--|-X-MTM-|T-B|-B-BX-----B|E|---X-T-?-T---E-EB--o-|E-----T--EE-E--T-E|o?------X---T--B-----o----?XM---------TM---B|?E--B--E--X--T-B-?---M|------------?o-|Bf
-M-----XX--TET--oME-B--?--?|ToMM---oX?E-XXM----TEX-B--EMoEB---M-T--MTB--?-TTE-T---XT---|X-o-B--o--o-|E--X----|B-TTX----M-M-------o-M--X|?E-Mo-?--M-----o---E--E-EE-?--o?o-|--X-M--|TX---|-X-Xo-oX--TT--f
-X------B-BX?oo?---oB---M---|B-oo?----|B--|E----?XM--|---?|----TB-X-XEBT-X--ToB|-M|B--M-M-?--B?--o--X---X?BX-------|M--To?o--M----o--EM---?B----E?M-oE--|-T-MB--oo-TTTBT--X-BTo-M-|-T|o----|-X-M------Tf
-M--?M|-|EE-E-o?X----MX-M-?X-----EBB-B--T---|-oBXBoE|oXET-T--|MM----T?------B?-B------X-MM-EX-|-o-BT---TM---oT-TE-M-----T-MM--E-B-M-TT-TMT-|o--|X----BM-|---TXoB-X----|----oX-XE?----o---E-----X-MX----f
---|-------E------|-o-E-?E-TT-ME---X---M-E-B-|------TXE-E-BXT-----BME-?oBMo-XE-|B--??---oB--?|-|-M--E-B----M--|----M|--?TX--T|T-BXX|-------E?-|E?TBo--B---TM-MB----BM---ToMXX-|--oM----X---X-|-Eo--?MBBf
mM--M---?-BTBBE---X-B-X----o--M---B-EB---M?ETB?oM--o|-B--o----M--X--EB|EM|ooo-T??--o-|--E---E--X--E---||B-M-?-|?-----EM--B-o-E----B|--------T-E--M-E--?--M-?EXX--oM----??o-?o-|M-E?MM?--|oM--|-M?--||B?X
XXEXXXXXXXXXXXXXXXXXXXXBXXXXXXXXXXXXXXXXXXXXXXXXXXXXXXXXXXXXXXXXXXXXXXXXXXXXXXXXXXBXXXXXXoXXXXXXXXXXXXXXXXXXXXXXXXXXXXXXXX-XXXXXXXXXXXXEXXXXXXXXXXXXoEXXXXXXXXXXXXXMXXXXXXXXXXXXXXXXXXXXXXXXXTXXXXXXX-XX
