-MB-------E----E--o-BE-------o--X-EX-BM---BX--BX--M----E------E--------X--XE-M-X---MM--M-X---B-----B--------?--o--o------B-o-Bo----M-X----X?---X-----E-M----B------X----E?---M----o-----E-EB-o--o-XEX---
---??M--X----o-XE-XB---------------M-o?-?oXB-------BMX------M?-----E---M-X----oo--oM------E--EM-oE---Bo--X-B-o?B--?-XE-?-?EB--?--X--M-----E-----B--?-?-B----B-?----B------------oB--XB------o-----XEX-B-
-o-X---oM---M-B--E?--M--?XE----EM-----EB----?M-B---BX--ME-B-----M?--------X?----M---oEBE-----o---o-X?-o-M-B--X----Mo?-B-X-o-----X--------XM--o-?---?---M-Bo-X-BXE---?XB-------------?-?B--o-E-------M-M-
------MX----?----o---?--?---E------X---?---B?M-------?-oB-----M---o?-EX-----M----M?-oM-------------BX--EX---?--MM--o---X-X---X--o-----o----M--oBXX--?X--Xo-XX-X---X-M-----BX-?----o-------E------o------
-M-------B--X-B-oEM----Eo-X?-E------?----o-X-?--EXB-?-----?-B-------o---o---B-E--?M-M--XX-B---Eo--?B-----XBMXM-oXX---E--B---oMo----oX-?---M--o--E----------?----X---o?----B-B-B---?-------------B-------
--X-M---oB--B---BX-E-E------E--oB?---X--X--B--E?--?--X-M-?-----?X-M---BX-------o---------------E-Xo----------MB-XBX-??-M-E------oM--EM---B-E------?Bo----X-B-o--Mo-----E-X-M?------M-??--------X--M-----
----M?M?-?--M-Xo-----?--o-------?MM------?MBoXX-----M---X-XE-----E---X-B--?-----M------X-oo-?-----E-----B?------EE--Bo----XM--o----------M----?-Eo----MM-ME-M?---XX?----XE------------E-----X--o-M----M-
---B----M?--XB-B--X---MB---MBE--EMB-------E----X-Xoo-X-------o-oBXB--E---X---------XEXM-E---?-E-----E-XBE--M--E-oXXo--EB?----X?---B-----?-----?---X-----Eo--M--?BM-----?--B-B--?-oMo--X----XX-M?--M--o-v
-X-?--o-?--X---?o?-?----M-?-E--------------X--E--EM-------o--B---BB-?-?--M----?-EE-E-Mo--MEMXE-------??-----------E-E-M?---oE-----E---BXB----E----E---MX-E----X---X?-B------?-?-o-?----E?-M-E-X--?B---?f
-B---XB-M-B------EBE--------MX--M----oM-?o-----oMXM-----?-----M-B-B-X-o---X-X--X----X-----Bo--oE--E-?---E?---X-o-?-X--M--Moo-M--------?----?-MBX-B-----BM?----?o-XB--X------M?o?---XEEB----B?---------?f
---EB----------M--EEB-E---EB-?-------oM----E-X--oM-X-----EX---o?---X-?-M?-M----M-----E--??-BE-?-X-E----E--?M---------MX?-E?o--???------o?-------o---o---X-B--?-B--?-------?-B--EX-?-o-?----o--XM-?ME?-of
-??-XM----------M---EEoEE-oX--X-BX?M--X---?-?-XX---o---X-oME---M---B----??---M------o-X----XM-oB---------M----BMM-B--EMB------o--oE-?X--?-XMo---o?-X---?--Bo--?-MB-Xo-B---BB--EXEME-E------B----BX-M---f
--E-------o-EX------?----M----?---?-X--Mo??---o---X----------X---M--E---M-----B?-o-o--o--B-----B-?-------------------B-----Xo-?--?---o-M----B-B?M----EXM-EX-----MX-B-----XXM--Eo--------o------X---?---f
-E-E-----Eo--oE------M?o-o--B--------E-o-?---X-o---?---EM?E-------BX?M-X-----oM--XM---o--?----M-?-M---BM--------E--oX---E-------------X?-M-----E-----X---X--o-----?ME--B?---M---XX----------o-?B-E-X-M-f
m------X-B----E-----BB-o-X-?---E-M--B--E-MM-X-E-B--?--?E----EX---?--E--MX--------B-EM--------E?----?--o-----M?B-----M-B--MMM?-B-M--M-?-o-B--B----B----B------M---B--B----X-o---B-EBo--EB---?-o-E-M---?-X
XXXXXXXXXXXXXXXXXXXXXXXXXXXXXXXXXXXXXXXXXXXXXXXXXXXXXXXXXXXXXXXXXXXXXXXXXXXXXXXXXXXX-XXXXXXXXXXXXXXXXXXXXXXXXXXXXXXXXXXXXXXXXXXXXXXXXXXXXXXXXXXXXXXXXXXXXXXXXXXXXXXXXXXXXXXXXXXXXXXXXXXXXXXXXXXXXXXXXXXX
