-------------------------------------------------------------------------------------------------------------------------------------------------------------------------------B------------------------
--------------------------------------------------------------------------------------------------------------------------------------------------------------------------------------------------------
--------------------------------------------------------------------------------------------------------------------------------------------------------------------------------------------------------
--------------------------------------------------------------------------------------------------------------------------------------------------------------------------------------------------------
-----------------------------------------------------------------------------------------------------------B---------------X----------------------------------------------------------------------------
----------------------------o-------------------------------------------------------------------------------X-------------------------------------------------------------------M-----------------------
------------------------------------------------------------------------X----------------------------------XX-------------------------------------------------------------------------------------------
-----------------------------------------------------------------------XX---------------------------------XXX-------??---------------------------------------------------------o-----------------------v
-----------------------------------------------X--------------o-------XXX--------------------------------XXXX---------------------------------------------------------?--------------------------------f
-----------------------------------------------XX------B-------------XXXX-------------------------------XXXXX------------------------------------------------------------------------------------------f
-----------------------------------------------XXX------------------XXXXX------------------------------XXXXXX---------------------------------------------------------------o--------------------------f
------XX---------------------------------------XXXX----------------XXXXXX--------------M--------------XXXXXXX-------------------------------------------------M-------------XXXXX------T---------------f
---------------------------------------------X-XXXXX--------------XXXXXXX----------------------------XXXXXXXX--------------------------------------------------------------------------|---------------f
-----------------------------------------------XXXXXX------------XXXXXXXX---------------------------XXXXXXXXX--------------------------------------------------------------------------|---------------f
m----------------------------------------------XXXXXXX----------XXXXXXXXX--------------------------XXXXXXXXXX--E--------------?--------E--------------------------M----------E---------|---------------X
XXXXXXXXXXXXXXXXXXXXXXXXXXXXXXXXXXXXXXXXXXXXXXXXXXXXXXXXXXXXX--XXXXXXXXXXXX-------XXXXXXXXXXX-----XXXXXXXXXXXXXXXXXXXXXXXXBBBBBBBBXXXXXXXXXXXXXXXXXXXXXXXXXXXXXXXXXXXXXXXXXXXXXXXXXXXXX|XXXXXX------XXXX
