XoT-M---?E---------M-----|-----E---E--E---BM------M---B?----------Mo-X--??BB--------|X|--o-------E?--?---?To---?M-B--BT-----o----------X|X||-X-X-------oo|-o--------------B------MT-o?oTT---ME---X-M---?
|---------|oX--E---------M?-T----o--|--E---|-------XBB--------Xo--?-B-----TX?----X---o-E--oME-----T--o------T-----E-ME-T--------|------o---BBo-----TB--?-------------X---M---BME--|T--X-?E----EoE-EME?-?
--------M--E---?E------------B----X-BE-E-X-?------M|-?--T------X-E--B---EB-B--BoT?--|B-E----|--X-M-|T-B?-|----X-o--?-B------TE--E-----?----|-XE----------oE-----E-------|----o--B-|oBXT---oET---E|--E--M
?-MB-?-------?--M------|T--MBB-M------XoM|--E|-----T--T---E---o------M?-o------M-|B----M?-E----------T------EE|EB-|--------B--T-oM-|-----oMM-?-------E----X----M----T----X-o--T--B--------EoT----BT|?--o
X----T-B?o----X--X-|T--B-M-?---------o|T-E---|X--X----------X---B----ET---X----M-?-E-----o-B--M--o--o-E--o--?-E------E---B--T-----|o----B--X-----Mo----E-B--M------T--?---E?----?T-o----------M-----|-EM
XX----B-------T-----E-M---M-M--ME--|-|-EB-----------T--o---E--T-----M------|-----X-o--o---B-----X|-?-E?-------TM------M--?-?--X?--T----------B-BX-o---E-X--T-------X--------o|----X----o-?-----|----|--X
-E-X------EE-EXo-o-E---------|BTEM--------X--|X---T-------M-T--?--T----X----?E---EM--T?--M-----?----|?-------|----------B---M-|X-o-oM---|----------E--T---------o--------?-X-----------------|-----?----
oo----|-M-B--E---------o-|---?---E-----|------B---------------|-E--E-----X-----M--E-TB-oT-M------E-----o-B--?Xo--EM--E-----o--TT-----T--?--B-o-|o--BX-----MX-----?-B---X|-B|-----|--?--|----X----------v
XX--M---------E---------M-----TETT--T-----oX--B----T------X-TEo---------------|X-?-B--E-----------M-T-X-----?M?---------?-|X-?-|------To----BX--------M------Xo-o----XM---|B-|--|-|B|--o-T-------------B
To---------T-|-?-MX--o----M------|-M?-E--TE-E------EM--T----o--------M----X---E---T---X-----TXE-|-T----T------oET---X-------EM----o---Eo--------|----M-B-----X-oE-X-E------B-o-o---o-E?-----B---|------T
o--M---------BB--M-M--M-------?-------------o---------T-o----M-E-E---------ME--XE----B------?---------o--B--E-X-M---------------M-T-T----o-----?------o-?o-o------|-------X--------------B-X--X---M----o
?--X|------E?---Bo--TT---|-M----o?---------------?---M--?------------X-----E-?----T-----E---o--------T----T---TX-E----M|----|--B----X-------TE--|---o--E---?---o---T--X-??-T---------M---?-X|-B---o----?
|----------------------E-----T-E-||--EB---M----?----B------?---o--E-----------Xo----E-X|BEo------T-X-B-|--B---?T---B-X--EM----|--X------|-T?---MB-|-o--B|----o------|--?-oE--X---EM----X-------ME-T----T
-----|-?--E|--E-----E-------|-B---E-|X---E-M-?-?-E-------------o--------T--|----o-T-oBM----XE--M----Xo--|-----MMT?X-X----M-----B---B--o--------B-------M-BTo---M--?|-E-XB-T-----X--------E---BM---?-?--?
m------o-------B-TB-?---?---------T-------B----M?--E----X-------E--------|--X-------M-M-T?-----|-o--M-o--M--T-------------TB?X------o----o?-o--------B-B-X||-B|--?------E--------M--B-----B-?-B---X---BB
XXXXXXXXXXXXXXXXXXXXXXXXXXXXXXXXXXXXXXXXXXXXXXXXXXXXXXXXXXXXXXXXXXXXXXXXTXXXXXXXXXXXXXXXXXXXXXXXXBXXXXXXXXXXXXXXXXXXXXXXXXXXXXXXXXXXXXXXXXXXXX?XXXXXXXXXXXXXXXXXXXXXXXXX?XXXXXXXXXXXXXXXXXXXXXXXXXXXXXXX
