-----------o-------------T-----E----------------------------------------T-------------------------------------------------------------------------------------------------------------------------------
----------------------------------o------------------------------------------------------------------------------------------------------------------------------------------B--------------------------
--------------------------------------------------------------------------------------------------------------------------------------------------------M-----------------------------------------------
----------------------------------M---------------------------------------------|----------------------------------------B------------------------------------------------------------------------------
---------------------------------------------------------------|------------------------------------B---------------------------------------------------------------------------------E-----------------
-----------------------------------------------------------------------------------------------------------------------------------------------------X--------------------------------------------------
----------------------------X--------------------------X------------------------------------------------------------M-----------------------------------------------------------------------------------
-------------------o--BM------------------B--------------------------------------B-----------------------------------------------------------------------------------------------------?---------------v
-----------------------X----X----------------------B-----?--------------------M-------------------------X---------------------------------------------|------------------------------------------------f
--------------------------------------------------------------------B-----------------------|---------------------?----------------------B---------------------------------------------------------|---f
-----------------------------o-----------------------------X------------------------T----------------------------------------------------------------------------------------?----------T--------------f
----------------------------------X--------------------------------X--------------B-----------B----------------------------------------------X---------------------------------------------------------f
------------------------------------------------------------------------------------------------------------|------------|------------------------?-------------------?--------------------------------f
------------------------------T--------------------------------T-----------B----------------B------------------X--------------------------T--------------------T-----M----------------B----------B-----f
m------------M----------------------------------------------------------------------------X------------------------------------------------------------------------------------------------------------X
XXXXXXXXXX-XXXXXXXXXXXXXXXXXXXXXXXXXXXXXXXXXXXXXXXXXXXXXXXXXXXXXXXXXXXXXXXXXXXXXXXXXXXXXXXXXXXXXXXXBXXXXXXXXXXXXXXXXXXXXTXXXXXXXXXXXXXXXXXXoXXXXXXXXXXXXXXXXXXXXXXXXXXXX|XXXXXXXXXXXXXXXXXXXXXXXXXXXXXXX
