------------------------------------------------------------------------------------------------------------------------------------------------------M-------------------------------------------------
--------------------------------------------------------------------------------------------------------------o-----------------------------------------------------------------------------------------
------------------------------------------------------------------------------------------------------------------------------------------------------------------------------------------------B-------
--------------------------------------------------------------------------------------------------------------------------------------------------------------------------------------------------------
---------------------------------------------------------------------XXXXXXXX---------------------------------------------------------------------------------o-----------------------------------------
---------------------------------------------------------------------------------------XXXX-------------------------------------------------------------------------------------------------------------
---------------------------------------------------------------------------------------------------?------------------------o---------------------------------------------------------------------------
----------------------------------------------------------------------------B-----------------?-------------------XX-------------------?????-------------------B---------------------------------------v
---------------------------------------------------------------------------------------------------------------M--------------------------o------------------------------------------------------------f
------------------------------------------X------------------------------------------------------------------------------X-----B--------------------------------------?--------------------------------f
--T--------------------------------------XX----------------------------------------X-----?------------------------------XX----------M----------------------------------------------o-------------------f
--|-------------------------------------XXX---------------------------------------XX-----------------------------------XXX-------BB----------X----------?????------------------------------------------f
--|------------------------------------XXXX--------------------------------------XXX------------------------------Mo--XXXX-----------------XXXXX-------------------------------------------------------f
--|-----------------------------------XXXXX-------------------------------------XXXX---------------------------------XXXXX-----------------------------------------------------------------------------f
m-|----------------------------------XXXXXX-------E----------------------------XXXXX----E-----------E---------------XXXXXX----------?--------------------------------------E-------------------E-------X
XX|XXXXXXXXXXXXXXXXXXXXXXXXXXXXXXXXXXXXXXXXXXXX------XXXXXXXXXXXXXXXXXXXXXXXXXXXXXXXXXXXXoXXXXXX------X-XXXXXXXXXXXXXXXXXX-----XXXXXXXXXXXXXXXX------XXXXXXXXXXXXXXXXXXXXXXXXXXXXXX--XXXXXXXXXXXXXXXXXXX
