-o------E---------------|---?B----XEE--o---------------E---M---M-----?--------B----X-----?B----------------??-?-------------------E---?----------B--M------ME---X-----------T-----X----------o----------
------M-----------------Xo---BB------------X-E-------B------------------M----------------?-------------------?-----E--------TM--------------------M-----X----------X------o-B--o---E--M--M---o---B----o-
--E-E-----M----?E---------------oo--B-B----------M-X-------o-------B-?----B-----------o----------T----------------?X--------X-----E---------?---?----------------------------------------X------o-------
------------B----X---------?--X--X--o---T----M---?EE-M----?-?-----?----------M----------------?--B---M---------------M----X----?-------------BM------M---------E-----T----------------------?----E------
-ET?--X?o------M-----?--------E--T--XM--X------?------------?-----?--M------------------B---B--E-M-----M-----?---B--XB---B---------?--------?---X------B----------X--?----B---------o-----------B----o?-
--M---------B---------M----------X---TM-------------E--------------M------?--M-X-----------?---B-E---?-Xo-------------------oE----M--------X-----------------EB---E-To--E---------------T-----------?---
---MX---?--------o-------------------M------E--X----M-?--EB-X-----E---X---BM---X-o---------o-E-X----X----X---------------M----o---B---------------M-------X-----M---BB---?----E-------o?X-----XE--------
---MoX--E-X----E-----------E-----E----B-----------E-----o---X--------M---B----MEM--------M--E---X---------M--?---X-------------------XX-------------------M------------------o------BT--------EBB-----Xv
------T--------------?--------B-------------------o-o-----E----------------------------------XEX------B-?-------------B-----------------X-----E----M--------MB-E-------BE-M----T----oM----M---oTX-E----f
-EX---|----------o--M--?--------T--------B---M------E------------------BE---o----M-----------o--------------------------?-X---------?---------E-----X-------M-----o-T-M---o----B-?----o--------M---?---f
---E--X------X----T--o-----?----X-B--------------?-------E--------E----------o------------MXo-T----------?--?----------------E-------B-----------------------TT-----X--------X---X---B------M----B----of
---------------E--MB--E------------------------?--B--B--------?-------o---------B--X----?-----?----X-?-o--M-------?----------------X---------E---------X-----XX-E----X--------T------E-B-----ME-------Ef
-----B------?----E----------------T----------------oM------Mo----X-------------------------M--------------------MB-------T---------M-----T---To--M------------o--o-?--o--T----X--o-o--T-------------M-Mf
-----E----------T-----XE---B------B---BM-B-B----------??-B-?--X--------------------?----------o----?--E-------?----X---?-|---X-B---E-----|---B-------?-----------M----?--?------------X----------------f
m-T--------M----|----X-X-E-----X--X--------M-TM--T--T--M--TM----B---X--X-Mo------------B------?---o-TT-------M-B---------M-B------M---X--X---------T-B-XT--------X--B--------T--XMM-X----B?--B-oTB---T-X
XXX-XXXXXXXXXXXXXXXXXXXXXXXXXXXXXXXXXXXXXXXXXXXXXXXXXXXXXXXXXXXXXXXXXXXXXXXXXXXXXXXXXXXXXXXXXXXXXXXXXXXXXXXXXXXXXXXXXXXXXXXXXXXXXXXXXXXXXXXXXXXXXXXXXXXXXXXXXXXXXXXXXXXXXXXXXXXXXXXXXXXXXXXXXXXXX-XX-XXX
