-------------------------------------------------------------------------------------------------------------------------------------------------------------------------------B------------------------
--------------------------------------------------------------------------------------------------------------------------------------------------------------------------------------------------------
--------------------------------------------------------------------------------------------------------------------------------------------------------------------------------------------------------
--------------------------------------------------------------------------------------------------------------------------------------------------------------------------------------------------------
-----------------------------------------------------------------------------------------------------------B---------------X----------------------------------------------------------------------------
----------------------------o-------------------------------------------------------------------------------X-------------------------------------------------------------------------------------------
------------------------------------------------------------------------X----------------------------------XX---------------------M---------------------------------------------------------------------
-----------------------------------------------------------------------XX---------------------------------XXX-------??-----------------------------B---------------------------o-----------------------v
-----------------------------------------------X--------------o-------XXX--------------------------------XXXX-------------------------------------------?----------------------?-----------------------f
-----------------------------------------------XX------B-------------XXXX-------------------------------XXXXX------------------------------------------------------------------------------------------f
-----------------------------------------------XXX------------------XXXXX------------------------------XXXXXX---------------------------------------------------------------o--------------------------f
------XX---------------------------------------XXXX----------------XXXXXX--------------M--------------XXXXXXX---------------------------------------X---------M-------------XXXXX----------------------f
---------------------------------------------X-XXXXX--------------XXXXXXX----------------------------XXXXXXTX--------------------------------------XX--------------------------------------------------f
-----------------------------------------------XXXXXX------------XXXXXXXX---------------------------XXXXXXX|X-------------------------------------XXX---------T----------------------------------------f
m----------------------------------------------XXXXXXX----------XXXXXXXXX--------------------------XXXXXXXX|X--E--------------?--E-----E---------XXXX---------|---M----------E-------------------------X
XXXXXXXXXXXXXXXXXXXXXXXXXXXXXXXXXXXXXXXXXXXXXXXXXXXXXXXXXXXXX--XXXXXXXXXXXX-------XXXXXXXXXXX-----XXXXXXXXX|XXXXXXXXXXXXXXBBBBBBBBXXXXXXXXXXXXXXXXXXXXXXXXXXXX|XXXXXXXXXXXXXXXXXXXXXXXXXXXXXXX------XXXX
