----------------------------------------------------------------------------------------------------------------------------------------------------------M---------------------------------------------
-E-----------------------------------------------------------------------------------------------------------------------------------------------------------------------------X------------------------
---------------------------?-T---------------------------------------------------------------------------------------------------------------------------------------------o----------------------------
----------------------------------------------------------------------------------------------------------------------------------------------------------------------------------------------------B---
----------------o---------------------------------X----------E------------------------------------------------------------------------------------------------------------------------------------------
------------------------------------------------------------------------------------?----------------------------------------------------------------------------------------------o--------------------
----------------------------?---------------------------------------E-------------------------------------------T-----------------------------------------o---------------------------------------------
----------------------------------------------------B---------------------o---------------------------------------------E------------------------------------------------------------------------------v
-----------|----------------------------------------------------------T--------T----------------------|---------T---------------------------------------B---------------------X------------------------f
-------------------------T---------------------------------------------------------------------------------------------------------------------------------?-------------------------------------------f
---------------------------------------------X-----------------------------------------------------------------------X-----------------------------------------------------o---------------------------f
------------------------------------------------?-------------------------?-----------------------------------------------------------------------|---T-------------------------------B---E------------f
----X-T---------E--X---------------------------------X----------------------------------------?-----------------o?----------------o--------B--------------------------------?------B----------------|--f
--------------------------------------|---------------?----------------------------------------------------B---------------------------------o------------B--------------------------------------------f
m----------------------------------MM-------------------------------------------------------------------------|-----o----------------------------------------------------------------------------------X
XXXXXXXXXXXXTXXXXXXXXXXXXXXXXXXXXXXXXXXXXXXXXXXXXXXXXXX|EXXXXXXXXXXXXXXXXX-XXXX-XXXXXXXXXXXXXXXXXXXXXXXXXXXXXXXXXXXXXXXXXXXXXXXXXXXXXXXXXXXXXXXXXXXXXXXXXXXXXXXXXXXXXMXXXXXXXXXXXXXXXXXXXXXXXXXXXXXXTXXX
