------|----oBEB-?E----X--TE--X--B--T--|T----M---||-oBX---oE-o---??--------|XT?--|ETo??-?-MM---EX--??--------B----E--EX------o-?-?EBT--||-E-XME-E--|o-B-E-XM-?|B--E-B|---MTE|--E-M-X----Eo------|--M--X--
-X-?E|ME----TM-?BE--|-TX|---MB----E---E--T-M---B-EM-E---B-?----EX--M-To---M-E-E----|MX-?-|-BoE-----B--B?MT--XTX-X-BT-------?E-oBTM--Mo--B?--o-To---B-------oMBBoT--M---T----TB---TM|-MX-E--M|-E----B-|?-
-B-B------B?M-------X----B|-B--o----E----?-X-BMM|oM-o-T--?-?-E----oMB----BX----M------o-M?--Mo-Bo------M---MoM|-BBBB----B-oMXT----|-|X----?-B-?---M----o-E-?---|??|--B-||EX----|-o-X--oo----o-----|X----
-----TX---Eo?-X-|---?---B---X------EX-T-o-o?X|?--XB|-T-oo-?|B-BXET----E-E--MMXX---ET----T--BX-E|?B-M-|o-----o--E------XBBX-X---|---T-T-o--M--E-EX--T-------B--?--EMo-E-MT---o-X---B-o?oo-E---EMoo-o-----
-?X--BMEB|T--o---E-M-?X---MEXBoXXB-X?---M-|E|----o--B-|B---E?--------E-?---ToE--|-XEE----T----E|X-M-------X---M?--?EM-B---M-|ME--EXM?----|--B||Eo---M-BB---TT-M---------ET--XTT-ooM-|-E-E-TM-|??M-ET|M--
-B-B----?T---M?--o--E|--X-E--BMBo-MX-X-?XMX---E--?-B--T---?|?BX-XX--T-X-E?o-------B-|-XB--E--XX-Bo-E-M-||o-|?-T--T-?--XXE----T---?o-TM|-E----o-E--E---?-?E-o--X|T--X-X-M-T----M?EBT-|-B|----|-----T--|--
-M-?-E|EX-----X?-BB-o-T-X--?oo--TEEX--XT--XBE---|-B|--X-?M-|?E--oM-T---?-o----o---B-M|--M?---E|--|EB---M------o|--X|--ToEM?M-----?-E-B-|-X--------E-?--E|-||--B------|--E?--|-?--M-MB--?--B---M--E-MT---
--X-|-To|-TBX-B-E?----|MB---?M-To-oM-MM--X--|--E--BXM-?M|?MT---|B-|--T----MM--M?--T-XE-X-B-?--T-?-EX-M-X-|o---M--|?--XT|---o---Bo--E---TT---B-----T|B---E-EE-T|-M?--B--B--?-MoXT-E---B-oX----MB-?-M-M-Tv
-EXB--BT--B---o-X?-XE----o--?M|X---X-|--|-M---XTE-----?-X|--|o-M--?E-M---oBoo--BT??E---|XE-T?-B?-?T?-E-XE-|-X-----EMT-X?-EX|M-B|-|E----M?XXTEMo---E-B--?-M-?T-T|X|oMB|-X?---BE|-?|X-------B--E-M---Mo-of
---E--?--M----TX------B-o---oE|--Mo---|--X-X--|-X-MTM-?T-B|-B-BX-----B|M|---X-T-?-----E-EB-Bo-|E-----T--EE-E----E--?------X--XT--X-----o----?Xo---------TM---E|EE--B--E--X--T-B-?---M|------------?o-|Bf
-M-----XX--TET-MoMEXB--?--?|T-MM----X?--XXM-B--ToX?B--EMoEB---M-T--MTB--?--TE-T---XT-X-|X-o-B--o--?-|E--X---E-B-TM-----M-M-----B-o-M---|?E-Mo-?--M-----o---E--E-EE-T----o-|----M--|TX---|-X-Xo--X--TT--f
-X------B-BE?o-?--EoB---M---|B-oo?--o-|B--|E----?XM--|---?|----TB-X-XEBT-X|-ToB|-M|B--M-M-X--B?-MX--X---X?B---------M--To?o-oM--M-o--EM---?B--T-E?M-oE----T-MB--oo-TT?BT--X-BTo-M-|-T|o----|-X-M------Tf
-M--o||-|EE-E-o?X----MX----X-----EBB-B--T-o-|-oBXBo||oXEB-T--|MM----T?----|-T?-B------X-MMMEX-|-o-BT---TM---oTo-E---E---T-MM--E-B-M--T-TMB-Xo--|X----BE-o---TXoB-X--X-|----oX-XE?----o---E-----X-MX----f
---|--|----E------|?o---?E-TT-ME---X---M-E-B-|------TXE-E-BXT-----BME-?o-Mo-ME-|B--?----oT--?E-|-|--E-B----M--|----M----MBM-M|T-BXX|-------EX-|E?TB-------TM-oB----BMo--ToMXX-|--oM----X---X-|-Eo--?MBBf
mM--E---?-BT|BE---X-B-X---Bo--M---B-EB-?--?ETEEoM--o|-B-------M-BX--E-|EM-oooBT??--o-T--E---E--X--E---||B-M-?-|------ME--B-o-E----B|--------TBE--M-E--?--M-?EXX--oM----??oB?o-|M-E?MM?--|oM--|-M?--||B?X
XXEXXXXXXXXXXXXXXXXXXXXXXXXXXXXXXXXXXXXXXXXXXXXXXXXXXXXXXXXXXXXXXXXXXXXXXXXXXXXXXXXXXXXXXXXMXXXXXXXXXXXXXXXXXXXXXXXXXXXXXX-XXXXXXXXXXXXEXXXXXXXXXXXXXEXXXXXXXXXXXXXXXXXXXXXXXXXXXXXXXXXXXXXXXXXXXXXXX-XX
