-----------------------------------------------------|---------------------|--------------------------------------------------------------------X----------------------------------------------------E--
------B------T-----------------------------------------M--------|-----------------------------------------------------------|-------------------------------------------o-------------------------------
------------------------------------------------------------------------------------------------------------------------------------------------|----------------------------------X--------------------
-------------------------------------------------------------------------------------------------------------------------B--------------------------------------------------------|---------------------
-----------------------X----------------------------------------------------------------------------------------------------------------------------------------------------------T---E-----------------
------------------------------------------T--------------------------X----------------|-----?-----------------------------------------------------------------------------------------------M-----------
----------------------------X--------E------------------------B-------------|-----------------------------------------------------------------------B----------M----------------------------------------
-------------------------X---M------------B------------------M----------T--------B---------------------?-----------B|----------------------------------------------------------------------------------v
--------------------------o------------------------B-------------------------------------------------------------------------------------------------------------?------------------------------M------f
--------------------------------------------------------------------B---------------------------------------T--------------------?-------B-------------------------------------------|-----------------f
-------------------------------------------------------------------------------------------------------------------------------------?---------|-------------------------------------------------------f
-----T----------------T------------------------------------------B----------------B----------------------------X----------------------------------------------------T----------------------------------f
------------------------------------------|-------------------B----------------------------------------------------------|----------------------------------------------------------o------------------f
-----------T---------------------------------------------o-----------------------------------------------------X---------------------------------------------------------------------------------B-----f
m---------------------------------------------------?------------------------T----------------------------------------------------------------------------------------------------------?--------------X
XXXXXXXXXX-XXXXXXXXXXXXXXXXXXXXXXXXXXXXXXXXXXXXXXXXXXXXXXXXXXXXXXXXXXXXXXXXXXXXXXXXXXXXXXXXXXXXXXXXXXXXXXXXXXXXXXXXXXXXXXXXXXXXXXXXXXXXXXXXXXXXXXXX-XXXXXXXXXXXXXXXXXXXXXXXXXXXXXXXXXXXXXXX|XXXXXXXXXMXX
