------------------------------------------B-------------------------------------------------------------------------------------------------------------------------------------------------------------
--------------------------------------------------------X--------------------------------------------X-----------------------------------------------------------------E---------------------------X----
-----------B--------------------------------T-------------------------------------------------------------------o-------------------E-------------------------------------------------------------------
------------E---------------------------|----------------------------------E-----------------------------------------------------------------------------------X----------------B-----------------------
----------------------------------------------------------------------T-----E---------------------------------------------------------------------------------------------------------------------------
---M----------------------------------T--------------?--------|--------------------o-----------------------------------?---------------------Mo---------------------------------------------------------
------------------------------------M---------------------------------------------------------------------------------------------?-------------------------B-------------------------------------------
----------------------M-------------------------------------------------------------------------------------------------|---------------|--------------------------------------------------------------v
--------|------------------B----------------------------o------------?---------------------------------X-----------------------------------------------------------------------------------------------f
----------------------------------------------------?-------------------------------X-----E-X------------------------------------------------------------------------------T---------------------------f
------------------------------o-----------------o-------------------------------------B--------------------------------------|---------------?------?--------------------------------------------------f
------------?------------------?-------------------T-----------------------------X------------------------|--------------------------T--------o--------------?----------------------------T------------f
--------------------------------------------------T--------------|-------------------------?-----------------------------------------------------------------------------------------E-----------------f
-----------------------------------------------------------------------------------------------------------------------------------------------------------------------?-------------------------------f
m--------------E--X-------------------------------------T--------------------------------------------M------------------T--------------------------|--------------------------------------B----B-------X
XXXXXXXXXXXXXXXXXXXXXXXXXXXXXXXXXXXXXXXXXXXXXXXXXXXXXXXXXXXXXXXE|XXXXXXoXXXXXXXXXXXXMXXXXXXXXXXXXXXXXXXXXXXXXXXXXXXX|BXXXXXXXXXXoXXXXXXXXXXXXXXXXXXXXXXXXXXXXXXXXXXXXXXXXXXXXXXXXXXXXXXXXXXXXXXXXXXXXXXX
