-----|---X----------X---T--o?|M------?------X?-----M-?----X-|E------M--------oB--o---|----M--E|--M------?---ET---M--oB-?----T-?-B-------B------X|------------E--X---B--T----MMEE----------o-B----TET-M--
--------------?-?T---B--------X---|oE----Xo----X-o------XTTT---X--|---X---MX-T----?--------oo-|------o------------TX-----B-E-X-X-|----------T--E----X----X-----EE-M--?--EM------o-----B-o|X-----To-?----
---B-----o---X|X----|T-E?--BT-o----o-M-B-----M--B-----?-X-----------X--------Eo---o-|--?-------------M------o--?-E----------X---TB----|B---|---|------M--o-X--MX-?-|Mo---?-?|----oX|---X-o---o--X-------
-X------E----ME--o-----Mo|---M--X|-B-----M----------M--B--T--X--------------TE-E----X---T-E--B---B--o-?--o-|--------M-o-EE---EXoE-------------?-----T---ME---E----T------?-M---X---X------METB----T--|--
----------M---|EM-M-XToM--XX-------------B-To-E-----M---|------XX----XX-E--MB-oX-----o-----X-?---BB--?ET---Bo---------------o-----M------o----X--o-|--E-?-|--o--------B---M--|-----o---?--M-o------M--M-
--B---E-MX-o---?---T?---B---------E?-o-------------X-M----M------||?-----B-E|-------M-----EB------B---?To------T-E--X?E-X--XBEMXEoX-M----o-M----E--T-o--E?-o--?-T-------X----------------?-?---B--------
---oM----|----oTM---B---?M--o-|-----------X------B-E-----?-E---B----------------B--B-B-E|--------------X---X---?------M--B--------?--M-----|---------M----E-T-|--o-------------o----T-?-----ME---XT--M--
-?----ME-E-TX-X----MT-----------X-|-----o----E--BE--X----?-------EE---B---------T----X-?|T-o----------||----o--??---M-------M--------?-----Eo---------------oB--B-XX-?o--------------------------------v
--M------E--T--T----T|------M------T-----------X---o-oM----oE?----------M------?-M----|--|----E----M--o|E|------------B-----EBX--o----B-|?---T-T---M----|-ME---B--M-------B-B-------|--M|XB---E?---M--Tf
--E-o-----?T-Mo---o-E----M------o------B--EM-T--?---MX------M----------o-B----T---------o|E-T-TX--EM?------o|MM----o-M--------Xo|-----B?------|-?E-B----------T-M-o----------E-B?-M-E--o----BT---------f
-T--X---MXX------X------B--o?----|------|-M-oBM----X--------------|----XEX-o--|X--B-B--?-o?-----B--------|--M-X-------------?-ETT-M-|?--?--|------B----M--B----M?---?---Xo|EX---M--o--?T---------------f
---E?--E---X--|---------E----------B----Mo---|----M-|---o-o?---EB------?-B---oB-E--M-T--oo----B?--------------------X-------To--B---|---oB---MM---M----X-o--EE-oT-EE-------?M--||----T-?------T----E--Mf
-----B?--B---M-E-M-M----E----?-X?--|T--Eo----X-oo--M------?----|------B---------E-E-------T--M-----MoXM----MM---?-o----M-|--------M--?---B----ET---MX-T----M--M----E--?T-X---B-------------o----B-|-X--f
--o--XB-T----M--------?------T----------B--o|?----E------?-E-o------?------E-----E-E-|T----------T----------o------M-o----oX---B-------BM-oE-B----------?----T---TE--X---M----T-XTE--T--B--E--?---M----f
m---M-----o--|----X-?-E----T----MX---MM-----------------B---XX---|TEM-M---?--B--T-T|?T-----?--B---E--E-M---B|BT--?M--B----oT-X-----?-|o--M-T--oX-M-?--T---X--T-E-----M---|---|-M-T----TEX-----|--T----BX
XXXXXXXXXXXXXXXXXXXXXXXXXXXXXXXXXXXXXXXXXXXXXXXXXXXXX-XXXXXXXXXXXXXXXXX-XXXXXXXXXXXXXXXXXXXXXXXXXXXXXXXXXXXXXXXXXXXXXXXXXXXXXXXXXXXXXXXXXXXXXXXXXXXXXXXXXXXXXXXXXXXXXXXXXXXXXXXXXXXXXXXXMXXXXXXXXX-XXX-X
