-M-----------------------------E---------------------------------------------------------------------B-------T-----------------------------T-------------------------------B----------------------------
-------------------------------------------------------------------------------------------------------------------------M------------------M---------------------------------M-------------------------
--------------------------------------------------------------------------------------------------------------------o-o-------------------------------------------------------------------------------E-
-------------------------------------------------------------------------------------------------------------------------B-----------------------------------------------X-------------------o----------
---------------?------------------------------?----------------------------o-----------------------------------------------T----------------------------------------------------------E-----------------
----------------------------------------------------------------------------------T----------------------------------------------------------X----------------------------------------------------------
----------------------------X---------|---------------------------o--------------------------------------------------------------------------------------------M---------------------X------------------
-------------------------X----------------------------------------------T------------------------------?----------------T------------------------------------------------------------------------------v
-----------------------X----X-----------------------------------------------------B----------------------------------------------------o--------------------------------------------------------------Bf
------------------------------------------------------------------------------------------------------------------?--------------?-------B---------M-----------------------------T-------------o-------f
---------------X|---------------------------|-----------------------------------------------B--------------------------------------------------|-------------------------------------------------------f
--------?-------------X---------X-X--------------------------------X-----------------?-------|--B----------X---------------------------------X---------------------------?------------------------o----f
---------------------------------------?--------------------T---------------------------------------------X--------------------------------------------------------------------------------------------f
----------------M--------------?-?E----------------------------------------B------------------------------------------------------------X--------------------------------------------------------B-----f
m-----------------------------------------------------------------------------------------X------------------------------------------------------------------------------------------------------------X
XXXXXXXXXXXXXXXXXXXXXXXXXXXXXXXXXXXXXXXXXXXXXXXXXXXXXXXXXXXXXXXXXXXXXXXXXXXXXXXXXXXXXXXXXXXXXXXXXXoXXXX-XXXXXXXXXXXXXXXXTXXXXXXXXXXXXXXXXXXXXXXXXXXXXXXXXXXXXXXXXXXXXXXXXXXXXXXXXXXXXXXXXXXXXXXXXXXXXXXX
