-----------------------------------T---------------------------------------------------?------------------------------------------------------------X---------------------------------------------------
----------------------------------------?-------------------------------------------o---------------------------------------------------------------X-------------------------------------------------T-
------------------------------------B-----------------------------------------------------?-------------------------------------o-----------------------------------------------------------------------
------------------------------------------------o--------------------o--------------------------------------------------------------------------------------------------------X-------------------------
----X---------------------------------------------------------------o------o--------------|--------------------------------------------------------------------------T-----X------M---E-----------------
---------------------------------------------------------------------------------------------------------------o------------------?---------------?-----------------------------------------------------
------------------------T-------------------T---------------------------------------------X-------------------------------------------------?-------B------------------T-----|--------------------------
------M-----------------------------------B-----------------------------T--------B-------------------------------o-------------------------------------------------------------------------------------v
--------------------------|---M-----------X--------B---------------------------------------------------------------------------------------------------------------------X-----------------------------f
---------------------------------X-------------------------------------------------------------------|---------------------------?-----------------X-----------------------------T---------------------f
--------------------------------------------------------------------------------------------|-?--------------------------------------?-------------------M-------|-------------------------------------f
----------------------------------X------------M-------B---------B----------------B------------------------------------------------------------------------?-------------?-----------------------------f
----------------------------------------------------------------X-------------------------------------------------------------------------------------------------------------------------B------------f
-------------------------X-------------------B----------------------------------------------------------------------------------------B------------------|-----------------------B---------------------f
m----------------------M------------------------------------------------------------?-----X----------------------------------------T-------------------------------------------------------------------X
XXXXXXXXXXXXXXXXXXXXXXXXXXXXXXXXXXXXXXXXXXXXXXXXXXXXXXXXXXXXXXXXXXXXBXXXXXXXXXXXXXXXXXXXXXXXXXXXXXXXXXXXXXXXXXXXXXXXXXXXXXXXXXXXXXXXXXXXXXXXXXXXXXXXXXXXoXXXXXXXXXXXXXXX|XXXXXXXXXXXXXXXXXXXXXXXXX?XXXXX
