----------------------------------------------------------------------------------------------------------------------------------------------XXXX------------------------------------------------------
--------------------------------------------------------------------------------------------------------------------------------------------------------------------------------------------------------
-----------------------------------------------------------X-M-------------------------------------------------o----------------------------------------------------------------------------------------
----------------------------------------------------------------------------------------------------------------------------------o---------------------------------------------------------------------
---------------------??---X--------------------------------------------?---oo---------------------------------------------------------------------------------------------------------------------------
-------------------B-----XX-----------------------------------------------------------------------------------------------------------------------------------------------------------------------------
------------------------XXX-------------------------------------------------------------------------------------------------------------------------T--------------------X----?---T---------------------
-----------------------XXXX-------------------------------------------------------o-----------------------------------------------------------------|-------------------XX--------|----------X---------v
----------------------XXXXX---------------------------------------------------------------------------------------------------------------?---------|------------------XXX--------|--?-----------------f
---------------------XXXXXX-----------------------------------------------------X-------------------------------------------------------------------|-----------------XXXX--------|--------------------f
--------------------XXXXXXX-------------------------------------------------------------X---------------------------------------------X------------T|----------------XXXXX--------|--------------------f
-------------------XXXXXXXX------------------------------------------------------------------------------------?-------------T--T----XX---T--------||---------------XXXXXX--------|X-------------------f
------------------XXXXXXXXX-------------------M--------------T---------------------------------------------------------------|--|---XXX---|--------||--------------XXXXXXX---B----|XX------------------f
-----------------XXXXXXXXXX---------------------M------------|---------------X------------X----------------------------------|--|--XXXX---|--------||----o--------XXXXXXXX--------|XXX-----------------f
m---------------XXXXXXXXXXX----------------------------------|----E---X-------------------XX---------------------------------|--|-XXXXX---|--------||------------XXXXXXXXX--------|XXXX----------------X
XXXXXXXXXXXXXXXXXXXXXXXXXXXXXXX-------XXXXXXXXXXXXXXXXXXXXXXX|XXXXXXXXXXXXXXXXXXXXXXXXX---XXXXXXXXXXXXXXXXX-----XXXXXXXXXXXXX|XX|XXXXXXXXX|XXXXXXXX||XXXXXXXXXXXXXXXXXXXXXXXXXXXXX|XXXXXXXXXXXXXXXXXX?XX
