----------------------------------------------------------------------------------?---------------------------------------------------------------------------------------------------------------------
---------------------------------------------------------------------------------------------------------------------------------------------------------o----------------------------------?---?-------
--------------------------------------------------------------------------------------------------------------------------------------------------------------------------------------------------------
-----------------------------------------------M------------------------------------------------------------------------------------------------------X-------------------------------------------------
-X--------------------------------------------------X------X-----BBBB---T--------------------------o-----------------------------------XXXX--X----------------------------------------------------------
-------B-------------------------------------------XX-------------------|-------------------------------------------------------------------XX----------------------------------------------------------
-----------------------------------------------T--XXX-------------------|------------------------------------------------------------------XXX---------X------------------------------------------------
-----------------------------------------------|-XXXX-------------------|------------------------------------------------X----------------XXXX---------------------------------------------------------v
-----------------------------------------------|XXXXX-------------------|-----------------------------------------------XX---------------XXXXX----------------------X-----------T----------------------f
-----------------------------------------------|XXXXX-------------------|-----------------------X----------------------XXX--------------XXXXXX---------------------XX-----------|----------------------f
----------------------------------------------X|XXXXX-------------------|---------------------------------------------XXXX-------------XXXXXXX--------------------XXX-----------|----------------------f
------------------o--------------------------XX|XXXXX-------------------|-X--------T---------------------------------XXXXX------------XXXXXXXX-------------------XXXX----------X|----------------------f
------------------------------X-------------XXX|XXXXX-------------------|----------|--------------------------------XXXXXX-----------XXXXXXXXX----------------o-XXXXX-----------|---------------------Tf
------------------------------XX-----------XXXX|XXXXX-------------------|----------|-----o-------------------------XXXXXXX----------XXXXXXXXXX-----------------XXXXXX-----------|---------------------|f
m-------E---------------------XXX---------XXXXX|XXXXX--E----------------|----------|---------------E--------------XXXXXXXX-E-------XXXXXXXXXXXE---------------XXXXXXX-----------|---------------------|X
X---XXXX????XXXXXXXXXXXXXXXXXXXXXXXXXXXXXXXXXXX|XXXXX-XXXX-----XXXXXXXXX|XXXXXXXXXX|XXXXXXXXXXXXXXXXXXXXXXXXXXXXXXXXXXXXXXXXoXXXXXXXXXXXXXXXXXXXXXXXXXXXXXXXXXXXXXXXXXXXXXXXXXXX|XXXXXXXXXXXXXXXXXXXXX|X
