-------?E-------------------?----------o---------------E---M---ME----?-E-----?BM--------o?-----------------?--?------E-----B------E--o?M---B------T-X-----------M-----------------X------?---o----------
--BM-------------------------BB------------X---------B-------------------o-B---X--M-------X-------X---T--------?-----B------------------E---------XE----X----------XBB----o-B--o--X---M--M-------B------
---------------?-X--o---------X-----------o---B?-M---------oB-----o-----?-------------o--------o------M------------?-T----M-X-----X---E-XX--?---?-------------M---------------?-------X--X-------B------
-B------o--------X---------?--X--X------T--------?oE-M----?-?---E-?-----?----MB----?-----------------M---------------M-----M---?--------EB---BM------M--------?E-----T----T--------------E-----M?E------
--T---E--------------??--X----E-E---XM--X----X--------------?---------------------------B---BM?E-----B-M---------T---B---B----?----?------------------------------X-?M----B---?----EE-------------------
--M-B---M------E-oo---M-------X------------------?--E-E----X-B-----------------------------------E---o-XM------X-|-o---o-----?---------?---X------X----E-----E--?----o-----M----E-----------X-----------
----X---?--------o---B-----o-----o----------E---o-----?-----X-----E---E---B--X-X-------------E------X----X-------|E------M--T------?--------------M----------?------B-----E---E-----------------------T-
----o---E------E-M---X--------E----T--------------------B------------M----o---B----------M--E---X---------M------B---M------X------B----------------------M------------------o?----------M----?-B-----?v
------T-------------------o--BB-??-?------------X-o-------------?E--------B--------M---------XEX------B---o--------------------------?--------E--------B----M--T-------BE------X--?-o-----M----M-------f
-EX--------------o-----?X--X----T--------B-?----------------------o-----E---o?---M----?-?----o----------E-------------------------B-----------E--------BX------M--o-T-M----o-----X----o-----?--M---?--of
---B--o------XB--BT--o----??----X-BB--------?----?B------E-------------------o---------?T-M-o--------------------?-----------E-------B----------X------------T------X--?-------------BX----------B-----f
---------------X--?---E---??--T------B------?--?---------?-T--?--------------B--B--X----?---------TX-?----o------X?--------T-?-X-------------E------?------XoX--E--------------------E-----?-M--------Ef
---E-B-T-B--?----------------BB---M---------------ooM------M-----X----------E--------E-----?------X-----E-----X-MB---------?-o-----o------------?--E----------o--o-?--o-------X----o--T----------------f
-----E-M---M----------XE---B-B----B---BM-BX--XT--------?-?-------------------------?---------------?--E------B-----X---?-M---E----X--------E-----M------X--------M----?---------------X------o---o-----f
m-T---?----M----T---M--X-E-----X-oT--------M-XMo-T--TE-M---M--------X-----o-----o------T--?---B-?-o-TX---o---M-----------ETB---------M--------------B------o--------------------------M-----oB-o-B---X-X
XXXXXXXXXXXXXXXXXXXXXXXXXXXXXXXXXXXXXXXXXXXX-XXXXXXXXXXXXXXXXXXXXXXXXXXXXXXXXXXXXXXXXXXXXXXXXXXXXXXXXXXXXXXXXXXXXXXXXXXXXXXXXXXXXXXXXXXXXXXXXXXXXXXXXXXXXXXXXXXXXXXXXXXXXXXXXXXX-XXXXXXXXXXXXXXXXXXX-XXX
