--------------------------------------------------------------------------------------------------------------------------------------------------------------------------------------------------------
-M---------------------------------------------------M-----------------------------------------o--------T--------------------------------------------------------o--------------------------------------
-----------------------------------------X--------------------------------------------------------------M-----------------------------------------------------------------------------------------------
----------------------------------------------------------------------------X---------------------------------------------------------------------------------------------------------------------------
----------------------------------------------------------------------------------|--------------------------------------------------------------T------------------------------------------------------
---------------------------------------M-------------------------------T------------?-------------------B---------------------------------T------------------------------------------------------T------
----------------------------------?-------------B--------------------------------------------------------------------X-----E---------------------------------------|------------------------------------
-------------------------B---------------------------------------------------------------------|--------|----------------------------------M------------B-------------------------------------------M--v
-------------------------------------------------------X----------------|------T----------------------|-------------------------------------------|-----B----E-----------------------------------------f
-------------------------M----------------------------------------o---B-----------------?---------------------------------------------------------------------|----------------------------------------f
-----T---------------------------------------------------------------T------------------------------------B-?--------X-----------------------------------------------------o---------------------------f
------------------|------------------------------B--------T---------------?-----------------------------------------------------------------------T--------------B-----------------------------T-------f
-----------------o--------------------------------------B------------------------X---M---------------------------?-----------------?-------T----------|----------------------------B-------------------f
-----?--------------------------------|------------------------------------------B---------------------------------------------------------------------------------------------------------------------f
m----------------------------------------|----------------------------------T--------------------------------------------------------------------------------------------------------------------------X
XXXXXXXXXXXXXXXXXXXXXXXXXXXXXXXXXXXXXXXXXXXXXXXXXXXXXXXXXXXXXXXXXXXXXXXXXX|XXXX-TXXXXXXXXXXXXXXXXXXXXXXXXXXXBXXXXXXXXXXXXXXXXXXXXXXXXXXXXXXXXXXXXXXXXXXXXXXXXXXXXXXXXXXXXXXXXXXXXXXXXXXX|XXXXXXXXXXXXXXX
