--------------------------------------------------------------------------------------------------------------------------------------------------------------------------------------------------------
--------------------------------------------------------------------------------------------------------------------------------------------------------------------------------------------------------
--------------------------------------------------------------------------------------------------------------------------------------------------------------------------------------------------------
--------------------------------------------------------------------------------------------------------------------------------------------------------------------------------------------------------
-----------------------------------------------------------------------------------------------------------B--------------------------------------------------------------------------------------------
----------------------------o-------------------------------------------------------------------------------X-------o-----------------------------------------------------------M-----------------------
------------------------------------------------------------------------X-------BBBBBBB--------------------XX--------------X----------------------------------------------------------T-----------------
-----------------------------------------------------------------------XX---------------------------------XXX------?------------------------------------------------------------------|----------------v
-----------------------------------------------X--------------o-------XXX--------------------------------XXXX-------------------------------------------------------------------------|----------------f
-----------------------------------------------XX------B-------------XXXX-------------------------------XXXXX-------------------------------------------------------------------------|----------------f
-----------------------------------------------XXX------------------XXXXX------------------------------XXXXXX--------------------------------------------------------------------T----|----------------f
------XX---------------------------------------XXXX----------------XXXXXX-----------------------------XXXXXXX---------------------------------------------------------------XXXXX|----|----------------f
---------------------------------------------X-XXXXX--------------XXXXXXX----------------------------XXXXXXXX------------------------------------------------------T-------------|----|--------????????f
-----------------------------------------------XXXXXX------------XXXXXXXX---------------------------XXXXXXXXX-----------X-------------------------------------T----|-------------|----|----------------f
m----------------------------------------------XXXXXXX----------XXXXXXXXX----------?---------------XXXXXXXXXX----------XX-----E-------------------------------|----|---------E---|----|--------E-------X
XXXXXXXXXXXXXXXXXXXXXXXXXXXXXXXXXXXXXXXXXXXXXXXXXXXXXXXXXXXXX--XXXXXXXXXXXX-------XXXXXXXXXXXXXXXXXXXXXXXXXXXXXXXXXXXXXXXXXXXXXXXXXXXXXXXXXXXXXXXXXXXXXXXXXXXX|XXXX|XXXX-----XXXX|XXXX|XXXXXXXXXXXXXXXXX
