------------------------------------------------E-----------------------------|--------------------------------?-----------------E---------------------------------------|------------------------------
------------------------------------------------------------------------------|------------------------------B----------------------------------------------------------o-------------------------------
----------------------------------------------------------------------------------------------------------------------------------------------------------------------------------------------------?---
--E-----------------------------------------------B---------------T--------T--------------------------------------------------------o-------------------------------------------------------o-----------
------------------------------------------------------------|--------------o-----------------------------------------------E--------------------|-------?------------------Xo----------E----------------
---------------B------------------------o-T-o-------------------------------------T---------?-----------------------------------------------------?------M----------------------------------------------
--------T-------------------------------------------------------------------------------T------------------------------------------|-------X--------B---------------------------------------------------
------------------------------------------------------------------------T--------B----------------------------------------------B-------------------|-------------------------B------------------------v
-------X-------------T-----------------------------B---------------X-----------------------------------------------------------------------------------------------------B-----------------------------f
------------------------------------T-------------|-----------------B--------------------T-?------------------------------------M--------B---------------------X---------------------------------------f
---------------------------?-------------------------------M-----------------------------------------E-------------------------------?-----------------------------------------------------------------f
----------------------------------X-----------------------------------------------B------------------------|---X---------------------------------------------------------?---------------------?-------f
------------------------------------------|-------------------------------M---------------------------------------------------------------------------------------o------------------------------------f
-----------------T--------------o----------o-B-----------o-----------------B--------------------------------------------------------------?------------------------------------------------------B-----f
m----------------------------------------------------------------------------E---T-------------------------------------------------T---------------------------------|---------------------------------X
XXXXXXXXXX-XXXXXXXXXXXXXXXXXXXXXXXXXXXXXXXXXXXXXXXXXXXXXXXXXXXXXXXXXXXXXXBXXXXXXXXXXXXXXXXXXXXXXXXXXXXX-XXXXXXXXXXXXXXXXXXXXXXXXXXXXXXXXXXXoXXXXXXXXXXXXXXXXXXXXXXXXXXXXXXXXXXXXXXXXXXXXXXXXXXXXXXXXXXXX
