--------?--------------E------------o-----------------o----------M-----E--T-?------------------------------------?----------E-----M-------X-?------o----X------------B-----?----B-----o-----------------
--------------------------------E---M-----?-----E----------T--------------?-----o---------------------XX---------??---E--------------------------M-------M--------------------------------M--?--E-------
---------------------o---XX-----o-T---------M---B----------?--?------ET---B-------M-----M-E-----M--------XM------E---Xo-----------------ME----M------o-?----------------------------B---------E-----M---
---M-------X--X-----E---ET--------M---------------X-------------?-----B-?M--o------------TX------?---------M------------------X--------------X----?T----------------?----E-------------E?---------------
-------------------------?---?---------X-------------?---?-------X--B------------M------oX--o-------ME-----------------B---B---E------B-X---T--M---|------------------M---------M-o--------------M-B----
-------E------------?B-X--B-------------?----------------B-------X----------B------o------------------------------X--------?---------------B?------X-o------------------------X----o--------------------
-----------------------E-------------o----------------o-----X-----o--------------M-?---?------------------------?------oT----E------------------M-M--?------------X--E-----------------T----------------
-?-----------------X-----------------------------------------B--------------------------E------------X-?T--X-----o-M----M-------------E--------o----------------------M--?-B-----------M??-------------v
--X-M-------X---T---------o-------M--?--BX---o---T-----o------------oBX--B-------------------M--B-------?--X--------------M---------------?---o---M---------X--------M-----M-----------B-EB------------f
----------------?-----------------E--T----------o?--------M-------------?---------------------------o---------------M---------T------------------o----BE---------X--o-----B----------E--BM-----X-T-----f
--------------------E----------X-M--BX-B---------------B---EX--X--------------o------------M---o----E-------o-E-----?---------?--------------------------------E-M------------E------M-------X---X--E--f
------------?--------?-------------------------o--o----?-----------X----------B-X----------o--?------------------------o-------M------X--E---B----------T--E-----------------X-----------X-------T-----f
-------------------------------M--------B------X-------------------------------------------o---------------------------?--------------------------------|--------X------------E--------------XX--|E----f
------E---o-------M--M-------B--o--------------------------------------------------------------------------B---?-o-----?-X--------B-------B-------------X----------?---------o----?----T--o------?-----f
m-T-------o-------------------T-----Eo-----------------------------o----B------------------M----------------B-------------------?-----------B----M----o---------?---E----T---------T--M|---------T-----X
XXXXXXXXXXXXXXXXXXXXXXXXXXXXXXXXXXXXXXXXXXXXXXXXXXXXXXXXXXXXXXXXXXXXXXXXXXXXXXXXXXXX-XXXXXXXXXXXXXXXXXXXXXXXXXXXXXXXXXXXXXX-XXXXXXXXXXXXXXXXXXXXXXXXXXXXXXXXXXXXXXXXXXXXXXXXXXXXXXXXXXXXXXXXXXXXXXXXXXXX
