---B----?------?-X-----E----o-----------?------------oo----------M-----E----------------M------------------------?----------E-----M-------X--------o----X------------B----------------o----------M------
----------------------?-------------------?-----E----------T--------------------o-----------o---------XX---------??-------------------------T----M-------M--------------------------------M--?--E-------
---T-------M----------------------T---------M---B----------?-B?-------TM--B--X----------M-E-----M--------XMT--EB-----X------------------ME--M-M-X------?--------------------o-----------------E---------
---?-------X--X-----X---E---------M-----------------------------?-------?M-----------------------?---------M---------------T--X-----------T--X-o--?T------------------o--E---M----------?--------E------
----B--------------------?----------?--X---M---------?---?-------X--B--?-----?-----------X--o-------ME-o----------X----B---B----------B---M----M---M----------------------------M------B---------M-B-o--
----|---------------?--X--B--------------M---------------B-------X----------B------o-------M-------o--------------X------B-?----o-----------?---M--X-o-----------------------------o--------------------
----M--------------------------------o----------------o---M-X-E---o-------E------M-?---?--------------X---M-----?B-----oT----------------------BM-M--?--------X---X------------------------B------------
----B-----------------------o--------------------------------Bo-------------------------E------------X-?-----------M----M-------------E--------o------------------o---X--?--------B----M?-----B-----o--v
--X-M-----------------------------M--?M--X---E-----ME--o---E----M---o-X--B-------------------M--?-------?--XB-------------M---o-X-----X---?------XM------B-MX--------M---E-M-----------B-E-------------f
----------------M--M--MB----------E-------------o-----------------------?-----------------M----X--------------------------------TB--------Eo-----o----XE---------Xo-o-----B----------E-B-M-----X-------f
----------o--------------------X--E-B--B--------------MB---E---X------E-------------X-----------------------o----?--?-M-------?-?--------------------------------M------------E-------?----------X--E--f
---------?--?--------?-----E-------------------o--o-------------------o-------B-X----------o--?---------------------------------------X--E---B-------------------E-----------X-----------X-------T-----f
------------------------------------M----------------------------------?-----------------------------------------------?---------X---------------M------------T-o-?-----------E-------M------XX--|E----f
------E---o----?--M------o---B--o------------------------E---------T------------------------------------------B--o-----?----------B-------B-X-----------------?----B---------o----?----T--o------?-----f
m-T--------------------T------T-----E---------------------M--------|------------T----------------------o--B-B------------?---E--?-----------B----M----o---------?MX-E----T--B------T---|-?-------X-----X
XXXXXXXXXXXXXXXXXXXXXXXXXXXXXXXXXXXXXXXXXXXXXXXXXXXXXXXXXXXXXXXXXXXXXXXXXXXXXXXXXXXXXXXXXXXXXXXXXXXXXXXXXXXXXXXXXXXXXXXXXXX-XXXXXXXXXXXXXXXXXXXXXXXXXXXXXXXXXXXXXXXXXXXXXXXXXXXXXXXXXXXXXXXXXXXXXXXXXXXX
