------------------?-----------------------------------------------------------------------T------------------------------------------T------------------------------------------------------------------
------------------------------------------------------------------------------------o----------------------T--------------------------------------------------------------------------------------------
------------------------------------------------------------------------B-----------------------M-------------------------------------------------------------------------------------------------------
-----------------------------------------------------B---B------------------------------------X-----------------o-----------------------M---------------------------------------o-----------------------
-----------------------------------------------------------------------------------------------------------------------------------------------------------------------------------------?--------------
-------------------------------------X-------------------------------------------------------------?------------------------------------------------------------------------------------------------T---
---------------------------E-----------------------------------------------------------------M-B--------------------X-----------------------------------------------o-----------------------------------
-----------------------------------------------X--------------------------------------------------T---------X-------------------------------B--------------------------------------------M-------------v
-------------------------------------------------------------------------------------------------------?---------------------------------------------T-------------------------------------------------f
---------------------------------------------------------------o-------------------------------?-------|---------------X---|---------------------------------------------------------------------------f
--------------------------------------------------------------------------------------------------------------------------------M----------------------------------------------------------------------f
--------------------------------------------------------------------------------------------T----------------------------------------------------------------T---------------------T-------------------f
---------------------------|---T---------------------|--------?T-----------------------------------------------------------------------------------------------------------|---------------------------f
--------X-----------------------------------------------?--------------T-----E-|-----------------------------------------------------------------------------------------------------------------------f
m-----------|---o-----------------------------------------------------------------------------------------?--------------------------------------------------------------------------------------------X
XXXXXXXXXXXXXXXXXXXXXXXXXXXXXXXXXXXXXXXXXXXXXXXXXXXXXXXXXXXXXXXXXXXXXXXXXXXXXXXXXXXXXXXXXXXXXX-XXX-XXXXXXXXXXXXXXXXXXXXXXXXXXXXXXXXXXXXXXXXXXXXXXXXXXXXXXXXXXoXXXXXXXXXXXXXXXXXoXXXXXXXXXXXXXXXXXXXXXXXX
