-------------------------------------------------------------------------------------------------------------------------------------------------------------------------------B------------------------
--------------------------------------------------------------------------------------------------------------------------------------------------------------------------------------o-----------------
--------------------------------------------------------------------------------------------------------------------------------------------------------------------------------------------------------
--------------------------------------------------------------------------------------------------------------------------------------------------------------------------------------------------------
-----------------------------------------------------------------------------------------------------------B---------------X----------------------------------------------------------------------------
----------------------------o-------------------------------------------------------------------------------X-------------------------------------------------------------------------------------------
------------------------------------------------------------------------X----------------------------------XX---------------------M---------------------------------------------------------------------
-----------------------------------------------------------------------XX---------------------------------XXX-------??---------------------------------------------------------o-----------------------v
-----------------------------------------------X--------------o-------XXX--------------------------------XXXX------------------------------------------------------------------?-----------------------f
-----------------------------------------------XX------B-------------XXXX-------------------------------XXXXX------------------------------------------------------------------------------------------f
-----------------------------------------------XXX------------------XXXXX------------------------------XXXXXX---------------------------------------------------------------o--------------------------f
------XX---------------------------------------XXXX----------------XXXXXX--------------M--------------XXXXXXX-------------------------------------------------M-------------XXXXX----------------------f
---------------------------------------------X-XXXXX--------------XXXXXXX----------------------------XXXXXXXX---------------------------------------T------------------o-------------------------------f
-----------------------------------------------XXXXXX------------XXXXXXXX---------------------------XXXXXXXXX---------------------------------------|---------T----------------------------------------f
m----------------------------------------------XXXXXXX----------XXXXXXXXX--------------------------XXXXXXXXXX--E--------------?--------EE-----------|---------|--EM----------E--------------E----------X
XXXXXXXXXXXXXXXXXXXXXXXXXXXXXXXXXXXXXXXXXXXXXXXXXXXXXXXXXXXXX--XXXXXXXXXXXX-------XXXXXXXXXXX-----XXXXXXXXXXXXXXXXXXXXXXXXBBBBBBBBXXXXXXXXXXXXXXXXXX|XXXXXXXXX|XXXXXXXXXXXXXXXXXXXXXXXXXXXXXXX------XXXX
