---------------------------Eo-------o--------E-------oo----------M-----E--------------?--------------------------?----------E---M-M-------X-?B-----o----X------------B----------B-----o----------M------
----B---------------------------E---M-----?---B-E---B------T--------------------o---------------------XX---------??---E-------------o------------M-----X-M--------------X-----------------M-X?----------
---------------------o--BX--------T---------M---B----------?--?------E-M--B--X---------?M-E--------------X-T--E--E----------------------ME----M--------?----------------------------B---------------M---
---M-------X--------E---ET--------M-----------------------------------M-?M-----------------------?---------M-----------------oX-----o-----E------M?----------------------------------------------E------
----T----E---------------?-M-?X------------M-------------?-------X--B--------?-----------X----------ME------------X----B---B----------B---M----M---?-----------------------------------B---------M-B-o--
----|------------------X--B-----------o-?M----------X----B-------X----------B------o------------------------------X--------?------?---------?------X-o--------------E---------X-------------------------
----X-----------------?E---X---------o----------------o---M----------------------M-?---?-----------------oM-----?------o------------------------M-M-B?--------X---X--E-----------------T----------------
-------------------X--------o-----------------X--------------B--------M-----------------E------------X---?--------oM------X--------------------o------------------o---M--?-B-----------X??----B-----o--v
--X-M-------X-X-----------o-------M--?---X---E---T-M---o------------o----B-------------------M-----------?-X--------------M---------------?---o-------------X--------M---E-M-----?-----B-EB------------f
------E---------M-----------------E----------B--o?----------------------?---------------------------o---------------X----E----------------E------o----XE---------X--------B----?-----E-B-M-----X-T-----f
----------o------------o---------M--B--B--------------MB----X--X--------------o----------------o----E-------o-------?-M-------?--------?-------------------------M---o--------E------------------X--E--f
------------?--------?--------------E----------o--o-------------------o-------B-X----------o--?-----------E--------------------M------X--E---B----------T--E-----------------X-----------X-------T-----f
-----------------------------------------------X--X-------------------------------------?-------X------------B---------------M--------------------------|--------X?--------------------------XX--|-----f
------E---o-------M--M----------o-----E----------------------------T---------------------------------------B-----X-----?----------B---------X-----------X------o---B---------o----?-------o------X-----f
m-T-------------o------T------T-----E------E--------------M-----M--M------------T---------------------------B------------E---E--?----------oB----M--------------?---E----T----T----T--MT---------T-----X
XXXXXXXXXXXXXXXXXXXXXXX?XXXXXXXXXXXXXXXXXXXXXXXXXXXXXXXXXXXXXXXXXXXXXXXXXXXXXXXXXXXXXXXXXXXXXXXXXXXXXXXXXXXXXXXXXXXXXXXXXXX-XXXXXXXXXXXXXXXXXXXXXXXXXXXXXXXXXXXXXXXXXXXXXXXXXXXXXXXXXXXXXXXXXXXXXXXXXXXX
