--------?o------------------o------------------------o-----------M-----EB--?----------------?--------------------?----------E-----M-------X-?------o---BX------------------?----B-----o----------X------
--------------------------------E---M-----?---B----------------------?----?--T----------------B-------XX---------??------------------------------M---X---M--------------------------------M-----E-------
------B-------------------------------------M---B-o--------?--?------ETM--B--X----------M-?M----M--X-----XMT--E--E---X-------------------E--X----------?--------------------------------------E---------
---M----o--X--X-----E---MT--------------?-------------X-----M--X------?-?---o-B------------------------M---M------------------X-----o--------X-----M--o------------------E--------------?---X----E------
-----?---------B---------?-M-?---------X---M--M--o---o---?-------X---------------M------oX-----------E------------X----B---B-M--------B--------M---T----------o-----X-----------M-o----B-------B-M-B-o--
-----------------------X--B---E--------M-----------------B-------X------------X----o---B--------------E-B--X------X----T-B-?--?-o-----------?------X-o-------o----------------X----o--------------------
---EX--------------E---E-------------o----------------o-----X-----o------?E--------?---?--------------X---M-----?B-----M----------------------------B----T------M-X---------------B-M--T-------M--------
-------------------X------?-o--------?-----------------o-----B---M-B---------M----------E------------X--T--X-------M----B-------------E--------o---------M--------------?--B----?-B----M??----B--------v
--X-M--M----X-------------?-------M---M-B--------T-M---o-------------B------------M-------------B-------?--X----E---------M?-------M----------o---M--B------X--------M---E-M--o--------B-E-------------f
------E---------M-----M-----------E----------B-Xo?----------------------?--o------------------------o---------------X---E--------T--------Eo-----o---MXE---------X--o-----B----?-------B-M-----X-------f
------------B-------E----------X-ME-B--B---------------B---EX--X--------------E----------------o----E------oo-E---B-?-----B-----M---------------E---X------------?------------E-------------oX---X-oE--f
------------?-MX-----?-----E----------------------o-------------------o-M-----B-X---o------o--?---------------------o--o-------M------X--E-B-B----------T-----------M--------X-----------X-------T--o--f
----X--------------------------M-----Xo--------E--------------------------------X---------------X------------B-M--------B---------------T--------------B|--B--T--X--------------X------o-----XX--|-----f
----------o-------M--M----------o-M---------M--------------------------------------------------------------B-----X-----?----------------|EB-X-----------B---o-?---?B--------------?----T--o------X----Ef
m-----?-------------B--T------o-----E----E-T--------------M--------o------------T----B----------------------B------------E------?-------B---B----M----o----------MX-EM---T------X------|---------T-----X
XXXXXXXXXXXXXXXXXXXXXXXXXXXXXXXXXXXXXXXXXXXXXXXXXXXXXXXXXXXXXXXXXXXXXXXXXXXXXXXXXXXXXXXXXXXXXXXXXXXXXXXXXXXXXXXXXXXXXXXXXXX-XXXXXXXXXXXXXXXXXXXXXXXXXXXXXXXXXXXXXXXXXXXXXXXXXXXXXXXXXXXXXXXXXXXXXXXXXXXX
