-----|---M----------X---T--o?|-------?------X?-----M-?----X-|E|-----M--------oB--o---|----M--E|--M------?---ET---M--oB-?----T-?-B-------o------X|--M---------X--X---B--T----MMEE----|-----o-B----TET-MB-
--------------?-?T---X--------X---XoE----Xo----B-o----?-XTET---X--|o--X---T--T---T?--------oo---------------------TX-----B-E-X-X-|----------T--E----X---o------EE-M--?--|M------o-----B-o|X------o-M----
---X-----o---X|-----|T-E?--BTXE----o-M-B-----M--B-----?-X-----------X--------EoT--o----?-------------M---------?-E----------X---TB----|B---|---|------M----X--MX-?-|Mo---?-?|----oX|---X-o---o-EX-------
-X------E-----E--o--E--Mo|---o--XX-B-----M----------M--B--T--X---X--------?-TE---B--X---T-E--B---B--o-?--o-|--------M-o-EE---EXoE------------X?---------M---oEB---T--------M---X---X------METB----T--|M-
---------TM---|EM-M--ToM--XX-------------B-To-E-----MMT-|------XM----XX-E--MB?oX-----o-----X-?---B---?ET----o--E-----B------o-----M------o---E---o----E-?-|--o--------B---M--|-|---o------M-o--B--MM--M-
------E?MX-o---?---T?---B---B-----E?---------------X-M----M------||?-----B-E|-------------EB------B---?T-------T-o--X?--X--XB-MXEoX-M----o-M-------T-o---?-o--?-T-X-----X----------------?-?---B--------
---o-----|----oTM---B---?M?-o-------------X--------E-----X-E--?X----------------B--BBB--|--------------X-------?------M--B--------?--M-----|---M-----X----E-T-|--o-------------o---MT-?-----M----XT--M--
-?----ME-E-T-EX----MT-----------X-|-----o----E--BE--X----?-------EE---BE--------T----X-?|T-o-----------|----o--??---M--o|---M--------?-----E------M---------oB-----X-?o-------------------o------------v
--M------E-----T----T|------M----X-T-------X---X---o-TM----oE?----------M------?-M----|--|----E----M--o-E|o-----------B-----EBX--o----B-|?---T-T-----B----M----B--M-------B-B-X-----|----XB---E?-X----Tf
----o-----?T-Mo?--o-E----M------o------B--EM-T--?----X--?---M----------o------T---------o|E---T---EM?-E-----|MM----o-M--------Xo|-----B?------|-?E-B----------T-M---X--------E--?-M-E--o-----T---------f
-M-MX---M-X------X------B--o?-----------|---oBM----X------M--?----|----XEX-o--|X--B-B----o------B--------|--M-X-X-----------?-ETT-M-|?--?--|------B----M--B----M?---?---Xo-EX---MMXo--?T----M----------f
---E?------X--|-----?-X-E----------B----Mo---|--|-M-|B--o-o?---EB------?-B---oB---?M-T--o-----B?-------E---E--------X-------To--B---|---oB---M|---M----X-o---E-oTTEE--------M--|-----X-?------T----E--Mf
------?--B---?-E-M-M----E----?-X?--|T--EoT---X-oo--M------?----|------B---------ET--B-?---T--------MoXM----MM-----o----M-|E-------M--?---B----ET---MX-T----M-----M----?T-X---BX-o----------o----B-|-X--f
--o--XB-M----M--------?------TT---------B--o|?----E------B-E?o------?------E-----E-E-|T---|------T-----------------M-oB--XooB-XB-------BM--X-B-?--------?--------TE--X---M----T-XTE--T--BE-E--?---M----f
m---M---E-o--|----X-?-?----T----MXE-EMM-----------------B---XX---|TEM-M---?--B-----|?T-----?--B---E--E-M---B|BT--?M--BM--Moo-X----X?-|o--M-T-----M-?--T-B-X--T-E-----M---|---|-M-T----TEX-----|--T----BX
X?XXXXXXXXXXXXXXXXXXXXBXXXXXXXXXXXXXXXXXXXXXXXXXXXXXXXXXXXBXXXXXXXXXXXX-XMXXXXXXXXXXXXXXXXXXXXXXXXXXXXXXXXXXXXXXXXXXXXXXXXXXXXXXXEXXXXXXXXXXXXXXXXXXXXXXXXXXXXXXXXXXXXXoXXXXXXXXXXXXXXXXMXXXXXXXXX-XXX-X
