----------------------------------------------------------------------------------------------XXXXXXX-----------------------------o----------------------------------------------------------------X----
------------------------------------------------------------------------------------------------------M-------------------------------------------------------------------o-----------------------------
--------------------------------------------------------------------------------------------------------------------------------------------------------------------------------------------------------
-------------------------------------------------------------------------------------------------------------------------------BBBBBBB------------------------------------------------------------------
-------------------------------------------------------------------------------------------------------------------------------------------XXXXXXXX-----------------------------------------------------
---------------------------------------------------------------------------------------------------------------------------------------------------------------------------T----------------------------
--------------------?????--------------------------------XXXXX-----------------------------B-------------------------------------------------------------------------------|---M------------------------
---------------------------------X----------------X------------------------------------------------------------------------------------------------------------------------|-M-------------------------v
--------------------------------XX-----------------------X-----------------------------------------------o-----------------B----------------------------------------X------|---------------------------f
-------------------------------XXX---------------------------------------------------------B---------------------B------------------------------------------B------------XX|---------------------------f
-BTBBBBBB----------------T----XXXX--------X--------------------------------------------------------------------------------------------------------------------------------|-------------?-------BBBBBBf
--|----------------------|---XXXXX?--------X-------------------------------------------------------------------------------------?-----------------T-----------------------|-----------------T---------f
--|-----------------T----|--XXXXXX---------XX---------------------X----------T---------------------------------------------------------------------|----------------X------|-----------------|---------f
--|-----------------|----|-XXXXXXX---------XXX-------------------XX----------|------------X--------------------------------------------------------|-----------------------|-----------------|---------f
m-|-----------------|----|XXXXXXXX---------XXXX-----------------XXX----------|-----oE----XX-----------E----------------E-----------E--------E------|----------------------?|?----------------|-E---M---X
XX|XXXXXXXXXXXXXXXXX|XXXX|XXXXXXXXXXXXXXXXXXXXXXXXXXXXXXXXXXX--XXXX?-XXXXXXXX|XXXX------XXXXXXXXXXXXXXXXXXXXXXXXXXXXXXXXMXXXXXXXXXXXXXXXXXXXXXXXXX-|XXXXXX-XXXXXXXXXXXXXXXX|XXXXXXXXXXX------|-XXXXXXXXX
