-|-|XE|--BE--?|-T-B--T-M-|-|-|X-X--|?X------T-----T--XTo--oEMoT----M-|M||-o-|M?-oXTMT----E-----M-Xo---|-B--o-------T--|-T?-M-M-o-|oM-----|-|?--X--|---------|--T-M----TX-MEM|M----E----o|?B-ME-X-|?T|-T-
---?MEX----T------o-E----?--T---X|---TEE-----T--?X-|--|B--Bo?-X-ToX-?--M?--X|--o--EEB-T?X------X-?-----XB-T?-o----M-XT--------T-E-X-X--E?--M-----T?EM-MB--MB--BT-------T---?BT---E---|M--T---T?X-Bo-E-X-
-XE-?-E-MMXT-B--T--------TB-oT----TT?XoEo|?----E------oM--------|B---B---|--?M-ET--T---XB|---E--E-To--|-|--?o----M-oMTMBo-M?E-o---o---?-B-----B|--?-T--o|--o|M----?---EXBMXo|XT-MT-----M?-|--X|--X|-?-B-
----E-?--?-?----o--EE|--XEo-?---T?o--|-o---|--|-----oTB--M--------M------B--|-X---oB-----E|------MMX--E---EEM?Bo|-o--M--M------Bo|--oT?T-?---------BB---|EB--X-o-E-XEXXBMM-TB-?T--T-o?MM--M--ooM-?--B---
----X-BM---ME|--B-BEBM-----E--B--?-|E---B---EX--XEX--E-E----o?MBT--B?-----X--oEM--X---|X-oE--E-?o-E|TE--EB--o----X---X-o--XM-TB--|--TB-|------T--M-----|X--oo--?-BM-BB-----X----X-?-?--oM--M-Mo-X--MB|--
-----X-B-------B-T----|--EM---X-BM----T-o------EM-oM-oE?--?-M-|X-----BB-X|-------TB??M--E-E-B--MEM-?--X---E--B----o-E-||oTBo|-B-?--X--o-||---M-E---E--XE-o---XB--XE--E-----M-B-MM-X|---B-X-------B-E--B-
--T|--X|--|--|XEEETT--T?E?-T-TT-|-|X---B--|T?------X-|----E--o-B----B--B|T-M-|?E---B--------B--E-?-B|T-?-B--?-E----TT---?----B-X--BoT--?B--|?-B---B-T---------BB--|-Eo--o--T---TM----|-B-?|--B--TETT----
-?-|----MoTXoE-T-B--X---o-M-?-----?TT?-M--M-o-o---B-XB-BE--M-oTE?-|X-----X------E---T--|----T--o-?Bo--------?-X---o---o---TEMTE?---|---B---?|-B-T---T-----------E--E?----o??--B-B-B-X-ET---BE------XM-Tv
-???----?-----T---Xo-?T-?|---------To||?----?Xo--o?--E--??-B--XXB--oT-o-B?--X?B--T-E-E--?-o----X---|---B----|oE?T-Xo-?--X--T---|--EMM---|-|-o-?-M-?--|E----XXMETBBE--|--X---T--?-?|-EoXX--o-----o-EoT--f
-B-XX-----------o-MB?-E-E-o--?--|XMXE-BBTT-EoM-?BBEBM-X--o-XB-----o-M-oBMM-TT--ToB-|---BTo-B-------M---|--|-T-M-B-o-EXM----EBTBMT--M?-----M-?---o-M|o-o---oEo----B---E-||E-E-X-?X-----M-X---|??-BE--|E-f
---o------?B----?--M--B----T--------X|-o-X--Mo|-X-||----XEBT---EB--?----?-?--E?----TE---o-T|---EM-?o---B---E----?-|X-BE---M-M-----X-B----|X-----o---o--oX----------MB-XXEo-B-E---o-E|----M---?E--M--?-of
---T?-TTT-o-Eo---ooM----MM---?o-B?--B-----ooB--|X--?-?-o?-B|--oE?|---?E--------B-o-E-|M----?TXE-?--o?E-|o--|--------M--?-B---M-M-?---?--?--T---|--o---------T-T-M-T?T-BoM----X----BB-E--T----o-o-|-?E--f
-M-??----|-----X-?---|--TB--XB-----B-?--B|BM---E--|----E-?BX-|---X----o|?MEEM-B--M--E-?-----o-T-|o------|?TM--MX--?X--?TM--Bo--M--T-?-Xo-M-?E--M---ooX|-XT--B---?--|MB----|EE-MM|-M----M-E-M-E?-BM??oT?f
--o--o---|-----E-BBToMMM--T-B--?--|?-M-XX-Mo-------|M----|E------X-T--T----MX-M-oo---?X---M------EE-|X--E|-?-X-|?E-TT--BX|-E?-|X?E---TB--B---?-EM??oET----o--?-----oo--XB--|--EEB?--o--X-|-?---B?o-B?o-f
mT|-B-|To|TM---TETo|-----MoX-?E--E--T-o-----o--E---TX--M?--TB-T-T---o--M-o---?---BM---TM------?---|--|o-T--------E-B---|--------B--||Eo|?---XoE----ETTB----MX--|----------oT-XX-----MX--o--?E-E-|----X|X
XXXXXXXXXXXXXXXX-XXXXXXXXXXXXXXXXXXXXXXXXX-XXXXXXXXXXXXXXXXXXXXXXXXXXXXX-XXXXXXXXXXXXXXXXXXXXXXX-XXXX-XXXXXXXXXXXXXXXXXXXXXXXXXXXXXXXXXXXXXXX-XXXXXXXXXXXXX-XXXXXXXXXXXXXXXXXXXXXXXXXXXXXXXXXXXXXXXXX-XX
