------|----oBEB-?E----X--TE--X--B--T-o|T----M---||-oB?---oE-o---??--------|XT?--|ETo??-?-MM---EX--T?--------B----E--EX------o-?-?EET--||oE-XME-E--|o-B-E-XM-?|B--E-B|---MTE|--EEM-XT---Eo------|--M--X--
---EE|ME-o--TM-?BE--?-TX|---MB----X---E---B?-T-B-EM-E---B------EM--M-To---M-E-E--M-|MX-?-|-MoE-----B--B?MT--XTX-X-BT-------?E-oBTM--Mo--BM--o-To---B-------oMBBoT--M---TB---TB---T---MX-E--M|-E----B-|?-
-B-B------B?M----E--X--E-B|-B--o-X--E----?-X-EM-|oM-o-T--X-X-E----o-B----BX----M--------M?--Mo-Bo------M|--Mo-o-BBBB----B-oMX-----|-|XX---?X--?---M----o-E-M---|??|--B-||EX----|-o-X--oo--E-o------X----
-----TX---Eo?-X-|---?---B---X------EX-TM--o?X|?X-XB|-T-oo-?|B-oXET----E-E--MMXX---ET----T--BX-E|?BXM-|o----?o--E------XBBX-X---|---T-T-o--M--E-EX--T-------B--?-BEM--E-MT-|-o-X---B-M?-o-E---EMoo-o-----
-?X--BM--|T--o-o-E-M-?X---MEX-oXX--X?---M-|E|----o--B-|B--TE---------E-?---ToE--|-XEE----T-----|X-M-------X---M?--?EM-B---M-|ME--EXM?----|-EB||Eo---M-B----TT-M---------MT--XTT-ooMM|-E-E-TM-|?-M-ET|M--
-B-B----?T---M?--o--E|-|X-E--BMBo-MX-T-?X-X---E-??-B--T---?|?BX-oX--T-XoE?o-------B-|-XB--E--XX-Bo-E-M-||o-|?-T--T|?----E----T---?o-TM|-E----o-|--E---?-?E-o--X|T--X-X-M-T----M?EBT-|-B|-|--|-----o--X--
-M-?-E|EX----EX?-BBEo-T-X---oo--TE|X--XT--XBE---|-B|----?M-B?E---M-T---?-o----o---B--|-E-?---E|--|EB---M-----|o|--E|--ToEM?M-B---M-E-B-|-X--?-----E-?-?E|-||--B------|--EX--|-?----MB--?--B---M--E|MM---
----|-?o|ETBX-B--?----|MB----M-To-oM-MM--X--|--E--BXM-?-|??T---|B-|--T-----o--M?--T-XE-X-B-?--T-?-EX-M-X-|o---M--|?--XT|---o---Bo--E-o-TT---B-----T|B---E-EE-T|-M?--B--B--?-MoXT-Eo--B-oX-----B-?-M-M-Tv
-EXBX-B---BX--o-X?--E----o--?M|X---X-|--|-M---XTE---T-?-X|--|o-M--?E-M---oBoo--BT??--E-|XE-T?-B?-?T?-E-XE---X-----EMT--?-EX|M-B|-|-----M?MXTEMo---E-B--?-M-?T-T|X|oMB|-X?---B-|-?|-----B--B--E-M---MM-of
---E--?--M----TX------B-o---oE|--Mo---|--X-X--|-X-MTM-?T-B|-B-BX-----B|E|---X-T-?-----E-EB--o-|E-----T--EE-E--T-Eoo?------X---T--B-----o----?Xo--?------TM---E|?E--B--E--X--T-B-?---M|------------?o-|Bf
-M-----XX--TET--oME-B--?--?|T-MM----X?E-XXM-B--ToX?B--EMoEB---M-T---TB--?-TTE-T-?-X|-X-|X-o-B--o--o-|E--X-----B-TMX----M-M-------o-M--X-?E-Mo-?--M-----o---E--E-EE-?--o-o-|--XoM--|TX---|-X-Xo-oX--TT--f
-X------B-BE?o-?---oB---M---|B-oo?M-o-|B--|E----?XM--|---?|----TB-X-XEBT-X|-ToB|-M|B--M-M-X---?--o--X---X?B---------M--To?o--M--M-o--EM--??---T-E?M-oE----T-MB--oo-TT?BT--X-BTo-M-|-T|o----|-X-M------Tf
-M--?MB-|EE-E-o?X----MX-M--X-----EBB-B--T---|-oBXBo||oXET-T--|MM----T?----|-B?-B--o-o-X-MM-|X-|-o-BT---T?---oT-TE-------T--M--E-BEM-TT-TMB-Xo--|X----BM-o---TXo|-X----|-E--oX-XE?----o---E-----X-MX----f
---|-------E------o-o-E-?E-TT-ME---X---M-E-B--------TXE-E-BXT-----BME-?oB?o-ME-|B--?----oB--?E-|-|--E-B----M--|----M---?MXM-T|T-BXX--------E?-|E?TBo------TM-oB----BM---T?MXXX|--oM----X---X-|-Eo--?MBBf
mM--M---?-BT|B----X-B-X----o--M---B--B---M?ETTEoM--X|-B-------M--X--E-BEM|ooo-T??----T--E---E--X--E---||B-M-?-|------EE--B-o-E----B|----B---T-E--M-E--?--M-?EXX--oM----??o-?o-|M-E?MM?--|oX--|-M?--||B?X
XXEXXXXXXXXXXXXXXXXXXXXXXXXXXXXXXXXXXXXXXXXXXXXXXXXXXXXXXXXXXXXXXXXXXXXXXXXXXXXXXXXXXXXXXXXMXXXXXXXXXXXXXXXXXXXXXXXXXXXXXX-XXXXXXXXXXXXEXXXXXXXXXXXXXEXXXXXXXXXXXXXXXXXXXXXXXXXXXXXXXXXXXXXXXXXXXXXXX-XX
