---------------------------------------------------X--------------------------------|----------------------------------------------------------------------------------------o--------------------------
-----------------------------------------------------M-----------------------T-----T--------------B--------------------------------------------------------------o--------------------------------------
------------------------------------------------------------------------------------------B-------------------------------X------------------------------------B----------------------------------------
-----------------------------------T-----|--------------------------------------------------------------------------------------------------------------------------------------------------------------
---------------------------B------X---------------X----------------o-----------------------------------------------------------------------------------M------------------------------------------------
-------------------------------------------|--------------------E--------------------------------------------T-------------------------------------------------------------|----------------------------
----------------------------------?-------------B-----------------------------------------------------------|-B-------------------------------------------------------------------------------------|---
-----------------------------------------------------------------------------------------------|--------|----------------------------------M------------B--B-------------------------------------------v
----?--------------------------------------------------X----------T--------------X------------------------------oB------o-------------------------|-----------------------T----------------------------f
--------------------------------------------M---------------------o---------------------?-------------------------------------------------------------M-------E----------------------------------------f
-----T---------------------------------------------------------T------------------------------------------B-----M---------------------------|---------------------------------------------------------Tf
--------------M---|-----------X------------------B--------T------------|--?B----------------------------------------M-----------------------------T--------------E---------ET------------------T-------f
-----------------------------------------------------X--------------------------------------------------------------------E-------------?--T----------|------------------------------------------------f
-------------------------------B------|---------------------------------------------------------------M------------------------------------------------------------------------------------------------f
m------?--------------------------------------------------------------------T--------------------?------------------------------------------------------------------------------E----------------------X
XXXXXXXXXXXXXXXXXBXXXXXXXXXXXXXXXXXXXXXXXXXXX|XXXXXXXXXXXXXXXXXXXXXXXXXXXX|XXXX-XXXXXXXXXXXXXXXXXXXXXXXXXXXXXXXXXXXXXXXXXXXXXXXXXXXTXXXXXXXXXXXXXXXXXXXXXXXXXXXXXXXXXXXXXXXXXXXXXXXXXXXX|XXXXXXXXXXXXXXX
