o--B-?T|B--XME--X-ME----X-----X--|--BX-BB---TE|o----|E-?E??oB--TBo-?--XM--B---------M---B?--BMB-?-|-EX----?B|T--?E-oT|-E?-E|----M-TB----X---EB-o--o-||E|EB-E||ooXTXoE-MBB---TTMTBMT-|---|---M-BMX-TXTEBE
E----|?----XX--------E|o---|T-XB-E-?E?oB-E--?--X--M-B----E|?---EX---?-oo----o-|----TME---TT-X-B--M----?oE-?-T?M-T--||-oB------T---?---|oo?--E----------BB--oXo----T--X--o||-|o-B|-E?--B--T-|-----|---?|E
X-o-T------B-T--|X--M-|X---|--M---|o-M--|-|-T??--B--E--ToT--E---?X--o?---T-B-oT--o-X-M--BB|-E--XBME-B-B-?--X-M|B-B--|-o-E-B-o--|-EE?E-E??B----M-?X---o--?-|--X---?-|-----M?M-----M--o---o-----------TBX-
-E-o----M-Eo?-EE-------MXB---EM----B--TB-?XT-MM-XMMB-------T-?|-?To-X------?E-E|-|-o--Eo?X----EEXBoT?--|---------M-|-----|----?-MoB-o-X|X-?--MoTE--XB-------?--Eo---?E-?o--E?-M--X-----B-MooT-X--o---XTB
|-X-o-----B-T-T?M?-|B-|-||--B---|---oB--BM--o--?--E---Mo-TT?-M|oEXoX---MXE-B?-T------------?-B--T----E-|BME-E-----TXXBT----TE----B---BX--Mo--E-M?--o-B---|o---X--?-ME------Xo--?--M-E--XEM---E-----|-MoT
----Mo----X--E-ETE-XB---?-|X---BB-?--X--E?----|-B----B--|-o---T-X-T--oE-E-B-|M|-T----------|T-E-B-X--?-B--BEE-M-oXB-E-oEM-B-B--?-oo----|-T||---X--M----o--X|-MB-----?-B----TX--oX---TTX-----------o--B-o
oME--oo--o------M|-M-----B-BEXXXB-|-E?----M-|------|----B--o-M|-MT-----?--BoT?E--o-?T----BT?To-E---o--EX-----Xo----M-EB-Xo-E-o--M-|-oB-oo-EB---oo-?--MT------o-----|---|-----|MMX-o---TE--T?E-M|E------M
E---oT-------E?---MET--M-T----TX-?oXM-M-Bo--oBo-???-X---ME-?o--|--E--?B---|---TB--EBM-?B--|--MB-X?-?|-E-B-Mo--E--EB----TMXo-oMX---XM--M---X-?--oT-ME---TXM-TB---B-X--T-ETE------?-Bo--o-X|----T---|--?-v
MT|X-ET---B--?-B|--E-o-----?---XE-XT---B--|X--|EM-MX-MMB---|-----TT----------?M?-TB|M-|-T-T-B--BX---------M-MT-|-X-T---o---o--|-MB-T|---T---BoB--M?--o-B--M?B--X-E-oMB--Eo-E-EE---T-X?--oo-?|--|-----T?o
--||T-BoM-?-o-B--E-E-----X-EM|-X-oE-Xo-X|---M-?M|--|o??o--------X-MET-|-B-o-X-Mo--?E-X-To--BM---|-BX---?BM-B----|---?---E--B-?M--E-|-M-MB----M-M-BXo-?-o--|-M?Xoo--B---o-BX-EM--?-oX-----|----M-?B-o-?M?
M?M-?MX------?-T|-XE|--XX?B?XX-T-T---o---|------B?oT--E-MX--|-------------------ET--?--?-M?--TMo---M---|T|-|---|---X-Xo?-E--X---B--?---M-|--?---|Mo-X--oX?-----B??o-BX-|TB-T-----oE-E-X-X-M--o-E---o--B?
E-?-M|-X|??B-XoEM-TM-E?-?--B-?-----||X|-T-|T|-|---X-TBT-o-------?|--|-oE?----ToT-E-----|--oT-E-??------?-MX---BT-X--E-o---o-|?-X??---oME?E-||To--ooT---B-M-----BE-X?-?M-?--?-X-M-MMT-TX--M---M----M---?B
T--?|??E?-o-oo?---TE--E--MM-M---T-----T--XETX--?M?--E-M-M-|---TX-|ET|--M-B-E-M?B--?o?E|TB---o-?--|-?X--T-oo---XoB-M--EE-------?--|-M-----M---E-M-E--TX---MoE---T-EoMEEBoT---|T--XM----?-X--B--|M----oE-X
?E|X|?BX-------ME-|-X-EXE-?-M-X--ET?o-------o-?-Xo-EBB---MT-|Boo----X-|-oB--E-?--XT|-----T-E-------?To|--o-M-B-?--M------B-B------|Xo--XME|-B---B----E-?-E---E--TXEE-XoM---MT--o-MEMMXBEB-o|-M---o---T-o
m------E---?X--TXBo---?------TM|---MX-o-T--E----?--XTE-E-BETX?o--o-----B----B---oXB-XX-o--|B--MX-E|-B?-?MB--|-T-oE-|E-B-E--MX-----oB--o---X--oM-o---Mo?---T-T-B--M----XM|-X--T---E-|-?-o--X-E---XM--BX-|
XXXXXXXXXXXXXXXXXXXXXXXXXXXXXXXXXXXXXXXXXTXXXXXXXXXXXXXXXXXXXXXXXXXXXXXXXXXXXXXXXXXXXXXXXXXXXXXXXXXXXXXXXXXXXXXXXXXXXXXXXXXXXXXXXXXXXXXXXXXXXXXXXXXXXXXXXXXXXXXXXXXXXXXXXXXXXXXXXXXXXXXXXXXXXXXXXXXXXXXX
