-B--M---o?B-MB---------------B--------------|----|----o--B--X---oEX----M--TE-EE-----o-----?------B-----------|-o--E-----M------E--------------M-----X---|------B-----X----|-E--------------------E----B-
-----T----E?-X---EB----o--o------------T--?-ToB-B--XBE--E-----X-o-oEE-------------B---M-?--E-EB-B--?o------------------X--------E---E--B-TT?--B------E---MMo--oM--------?-----M|----|------------oM-----
-E-E-Bo-----B----M---o--ET---o---|------T-----|B------T--XE-----M--EM---B---------M--B---------oE--------Xo?--|-----o---M--?--??---|--T-----------------E--M--M--|-------------------X----M------B-B--X-
-------B------|--oXE---E-----|-?---?----------T-T------EE--------X---o?E-------------E----o--?-B--?------M------|o-T-T-M-?-B----T----MT-o-----X------E--|-o?-----------|------B----M------|-----oE------
--B--B-?-BTE-EX-T-|--------?-------o----------TM--T---EM----?-B--------------o---E-----T-------M----B--EB|----Eo-X--|---T|----------o-----MT----E--------|---|-----TM-T-o-M--X-------M---M-------B-?----
-E------------M---o---?-M-----------------|?------|---M--B--X-X--M----E--E---T---X--?EM---B------E----M--E-|-EB------|-EET----T-B----Xo----M-M-E----o---|-|-----o---T---|---E--T-------?XM-X----E--B----
--?-?--X-------|---------T---Bo--|M----E------E-----oB-------?----o--|E---M---------?---BB|------------?--|------?T----T-------X---TE---EM-M--M---|-X-XE---X-?-------------o----B--|T|E--B-----?-|------
------XM?-E--------E-M-----o--B---------B------oX----XTB------X----E-------M-------X----B-------------BM-------o-T--oX--------o-------o----M---oTT--E----B---|------M---E--E--|-B------------|--B?----Mv
---ETE?--|-o??----o-M------------|--------------M--TB--oM-----T--o----X--EM-----------E--X----E?|--------|-----T|-----X----?--------|E|------------------T------X-M-T---B--o---E|B-M?------o-o------T--f
------?MB-----?o----|?---|E----E--|---------------o---B---|Xo---X-----o---------TB-----?-------B--?--------o-M----------X-----?--o-----B-BT-------------------oM---------B-----BE-----|-----MM--E--T---f
---E---E-----TB|X--?-T-o-X-?-o-------|-----------B----|M--?-M---MoX-|-XBME-T---T-|---|-X----|-XX---------?B-X--------?-----------------|---B-----X--?X---o-------B----------M----M|-|-|T---------M-B-oTf
-?-|T----|----------------------------B----?-E------?M---T--B---o--T----M----E-M-?----------|-?--B-------|-X--B--?-----?---o----?-?oE---X|--------E---o-B---B--?X-T-M---X--?-----|E|------------B-B---?f
-------B-----------X---M---?-E---M---B---------B-?B--E--T----------X--|B-M-------------------?-------TX--?--------o--E----B---Mo------?---------B--?----?--X------o--T--------XE?-o-T---|--T-?-X--|-M-|f
---Eo-------|--|-------T------B--E--------o?T---M?o----E--X----|-X-----------o--------?----XM------B---|M-----B------M---|-BM----||B-oM-|?-----M--|---|--EE-----?E---B-----M-B-X-B-----------M?-?--B-?-f
m----?-|--o----TT----|--?-----T--M------B-o-|-------X------------------------E---X------?---X-----B------------o----o------X-----?--TT-X--M--Bo--E-----E--?|---?---M--M--B-------B-|------E---X--|-----X
XXXXXXXXXXXXXXXXXXXXXXXXXXXXXXXXXXXXXXXXXXXXXXXXXXXXXXXXXXXXXXXXXXXXXXXXoXXXoXXBXoXXXXXXXXX-XXXXXXXXXXXXXXXXXXXXXXXXXXXEXXXXXXXXXXXXXXXX-XXXXXXXXXXXXXXMXXXXXXXXXXXXXXXXXX|XXXXXXXXXXXXXXXXXXXXXXXXEXXXX
