--------------------------------------------------------------------------------------------------------------------------------------------------------------------------------------------------------
------------------------------------------------------------------------------------------------------------------------------M----o--------------o-----------------------------------------------------
--------------------------------------------------------------------------------------------------------------------------------------------------------------------------------------------------------
-------------------------------------------------------------------------------------------------------------------------------------------------o------------------------------------------------------
---------------------------------------------------------------------------------------BBBBBBBB-----------------------?---------------------------------------------------------------------------------
--------------------------------------------------------------------------------------------------------------------------------------------------------------------------------------------------------
------------------------------------------------------------------------------------------------------------------------o-------------------------------------------------------------------------------
----------------------M------------------------------------------------------------------------------------------------------------------B--------------------------------------o---------M------------v
-------------------------------------------------------------------------------------------------------------------------------------------------------------------------------------------------------f
-------------------------------------------------------------------------------------------------------------------------------------------------------------------------------------------------------f
----------------------------------------------------T-------------------------------------------------------------------------------T-----------------o------------------------------------------------f
----------------------------T-----------------------|-------------------------------------------------------------------?-----------|------------------------------------------------------------------f
----------------------------|-----------------------|-------------------------------------------T-----------------------------------|----------T----------------------------------------------------X--f
----------------------------|---------T------------?|???----------------------------------------|---------------o--B---------------T|----------|---o---------------------------------------------------f
m---------------------------|---------|-------------|-----------------------E-------------------|------E--------------E------------||----------|-------------------M-----------------------------------X
XXXXXXXXXXXXXXXXXXXXXXXXXXXX|XXX---XXX|XXXXXXXXXXXXX|XXXXXXXXXXXXXXXXXXXXXXXXXXXXXXXXXXXXXXXXXXX|XXXXXXXX--XoXo----XXXXXXXX??????XX||XXXXXXX---|---XXXXXXXXXXXXXXXXXXXXXXXXXXXXXXXXXXXXXXXX-XoXXX------X
