-----|--------------X------o-|-------?------X?-----M-?----X-|E------M--------oB--o---|----M--E|--M------?---ET---M--oM-?----T-?-B-------o------X|--M---------X--X---B--T----MMEE----------o-B----TET-M--
--------------?-?T---XX-------X---XoE----Xo----X-o--E---X-TT---X--|---X------T---T---------oo-------------|-------TX-----B-E-X-X-|----------T--E----X---o------EE-M--?--EM------o-----B-o|X-----To-?----
--X------o---X|X----|TTE?--BT-E----o-M-B-----M--B-----?-X------B----X--------EoT--o------------------M------o--?-E----------X---MB----|B---|---|------M--o----MX-?X|Mo---?-?|----oX|---XEo---o--X-------
-X------E-----E--o-----MoE---M--XE-B-----M----------M--B--T--X------------?--E-E-B--X---T-E--B---B--o-?--o-|--------M-o-EE---EXoE-------------?-----T---ME--------T-B----?-M---X-MT-----|-M-TB----T--|--
----------M?--|E--M--ToM--XX-------------B-Bo-E-----M-T-|------XX----XX-E--MB-oX-----------X-----BT--?ET---Bo--E-------o----o-----M--------------o-|--E-?-|--E--------B---M--|------------M-o------M----
-X----E?MX-o?--?---T?---B---B-----E?---------------X-B----M------||?-|---B-X|-------------EB------Bo--?T-------T-o--X---X--XB-MXEoX-M----o-M----E--T-o--E?-o--?-T-o-----X----------------?-?---B--------
--BoM----|----oTM---B---?M--o-------------X--------E-----?-E---B---E------------B--B-BoE|----------------------?------M--B--------?--E-----|---M-----X----E-T-|--o--------|---|o----T-------ME---XT--M--
-?----ME-E-T--X----MT-------------|-----o----E--B--------?-------EE---BE--------T------?|T-o-----------|----o--??---M---|---M--------?-----Eo---------------oB----XX-?o-------------------o--o---------v
--M------E-----T----T|------M------T---------------o-TM----oE?----------M------?-M----|--|----E----M--o-Eo------------B-----EBX--o----B-|M---T-T--------|-ME---B--M-------B-B-------|---|XB---E?------Tf
----o--B--?T-Mo---o-E----M------o------B--EM-T--?---MX-----------------o-B----T---------o|E-T-TX--EM?-------|MM----o-M--------Xo|-----B?------|-?E-B----------T-M------------E--?---E--o----BT---------f
-M--X---MXX------X------B--o?-----------|---o-M----X-------------------XEX-o--|Xo-B-B--?-o?-----B--------|--M-X-------------?-E-T-M-|?-----|------B----M--B----M?---?---Xo-EX---M--o--?T----M-------B--f
---E?--E---X--|---------E----------B----|o---|--|-M-|B--o-o?---EB------?-B---oB-E-?M-T--oo----B?-T-----E------------X-------T---B------BoB----M---M----X-o--|E-oT-EE-------?M--|-----T-?-----------E--Mf
-----B?--B---?-E-M-M----E----?-X?--|T--E-----X-oo--M------?----|------B---------E---------T-----M--MoXM----M--?--------M-|--------M--?---B-T--ET---MX-T----M--M----E--?T-X---BX------------o----B-|-X--f
--o--XB-T----M--------?------TT------------o|?-E--E------B-E-o------?------E-----E-E-|T---|-----?T-----------------M------oXB--B-------BM--E-B----------?--------TE--X---M----T-XT---T--B--ET-?---M----f
m---M-M---o--|----o-?-?-T--T----M-E-EMM-----------------B---XX---|TEM-M---?--B-----|?T----XM-oB---E--EMM---B|BT--?M--B---Moo-X----X?-|o--M-T---X-M-?--T-B-X--T-E-----M---|---|-M-T----TEX--o--|--T----BX
XXXXXXXXXXXXXXXXXXXXXXXXXXXXXXXXXXXXXXXXXXXXXXXXXXXXXXXXXXXXXXXXXXXXXXX-XMXXXXXXXXXXXXXXXXXXXXXXXXXXXXXXXXXXXXXXXXXXX-XXXXXXXXXXXXXXXXXXXXXXXXXXX-XXXXXXXXXX-XXXXXXXXXXoXXXXXXXXXXXXXXXXMXXXXXXXXX-XXX-X
