-------------------------------------------------------------------------------------------------------------------------------------------------------------B------------------------------------------
-------------------------------------------B-----------------------------------------------------------?------------------------------------------------------------------------------------------------
-------------------------------------------------------------------------------------------------------------------------------------------------------------------------------------------E------------
-----------------------------------------------------------------------------|---------------------------------------------------------------------------------------------------T----------------------
---------------------------B----------------------X---------------------------------------------------|------------------------------------------------M----------------E--T----------------------------
-----E----------------------------------------T-----------------------------------------------------------T---------B-----------------------------------------------------------------------------------
---------------------------------------------------------|---------------------------------------------------------------M-------------------------------------------------------------|----------------
--------------|--------------------------------------------------------------------------------|------------------------------------------T------o-----------------------------------------------------v
-------------------------------------------------------------------------M-----T-------M----------T--M---------------------o--------------------------------------------------|------------------------f
--------------?--------------------------------------------------------------------------------------------------------------------------------------------------------------B-------------------------f
-----T--------------------------------------------------o--B---------T--------------------------------------?--------X-------------------------T-------------------------------------------------------f
-------------------------------------------------B------------T-------X---??-------------------------------------------B-----------------------------------------B---------------------|---------------f
-------------------X----X----------------------------X------------------------------T------------?----------------------T------------------B---------------------------------------B-------------------f
------------------------------------------------------?---------------------------------------------------------------------------------------------------B--------------------------------------------f
m-----------------------------------------?-T-----------------------------------------------------------------|-----o---------------------------------------o---------------------------------o--------X
XXXXXXXXXXXXXXXXXXXXXXXXXXXXXXXXXXXXXXXXXXXXXXXXXXXX|XXXXXXXXXXXXXXXXXXXXXXXXXXXXXXXXXXXXXXXXXXXXXXXXXXXXXXXXXXXXXXMXXXXXXXXXXXXXXXXXXXXXXXXXXXXXXXXXXBXXXXXXXXXXX|XXXXXXXXXXXXXXXXXXXXXXXXXXXXXXXXXXXXX
