----------------------------------------------------------------------------------------------------------------------------------------------XXXX------------------------------------------------o-----
--------------------------------------------------------------------------------------------------------------------------------------------------------------------------------------------------------
-----------------------------------------------------------X-M-------------------------------------------------o----------------------------------------------------------------------------------------
------------------------------------------------------------------------------------------------------------------------------o-------------------------------------------------------------------------
---------------------??---X--------------------------------------------?---oo--o------------------------------------------------------------------------------------------------------------------------
-------------------B-----XX-----------------------------------------------------------------------------------------------------------------------------------------------------------------------------
------------------------XXX-------------------------------------------------------------------------------------------------------------------------T--------------------X--------T----------T----------
-----------------------XXXX-------------------------------------------------------o-----------------------------------------------------------------|-------------------XX--------|---------?|---------v
----------------------XXXXX-------------------------------------------------------------------------------------------------------------------------|------------------XXX--------|--?-------|---------f
---------------------XXXXXX-----------------------------------------------------X-------------------------------------------------------------------|-----------------XXXX--------|----------|---------f
--------------------XXXXXXX-------------------------------------------------------------X---------------------------------------------X------------T|----------------XXXXX--------|----------|---------f
-------------------XXXXXXXX------------------------------------------------------------------------------------?-------------T-------XX---T--------||---------------XXXXXX--------|X---------|---------f
------------------XXXXXXXXX-------------------M--------------T---------------------------------------------------------------|------XXX---|--------||--------------XXXXXXX--------|XX--------|---------f
-----------------XXXXXXXXXX---------------------M------------|---------------X------------X----------------------------------|-----XXXX---|--------||-------------XXXXXXXX--o-----|XXX-------|---------f
m---------------XXXXXXXXXXX----------------------------------|----E---X-------------------XX---------------------------------|----XXXXX---|--------||------------XXXXXXXXX---E----|XXXX------|---------X
XXXXXXXXXXXXXXXXXXXXXXXXXXXXXXX-------XXXXXXXXXXXXXXXXXXXXXXX|XXXXXXXXXXXXXXXXXXXXXXXXX---XXXXXXXXXXXXXXXXX-----XXXXXXXXXXXXX|XXXXXXXXXXXX|XXXXXXXX||XXXXXXXXXXXXXXXXXXXXXXXXXXXXX|XXXXXXXXXX|XXXXXXX?XX
