--X---|----E-------T--TXo----------------X---o--?--ooB------|----E-o-T?--M----------M----T-X------X------o-----|--M----?-E---M-M------T---o-?---|--B---------B------B----M----MB-E--E-------------------
------B---|-o--TMB--------Eo-|-------------------E-----------T--?BMM--B----?------X---M|-------M-TE-------E---|T------E--XX---?-----|--E---------------|------M-------BM----o---XT----B---o--T---|?---B-
----X----XM|-B------?XB----X--X----------------T-----B---------------T--B-----?-M---T--------E---------X---T-?-o-?-------M---T-----o-T-----------X?o---X---Mo-|----|----M--------?---X--TT-B-----B---EX-
-----E-M--E-X------|-----B---------B---E--E-EX-??T--X----o----X--------o|-?-------M--?--?-----------XT-o--|--E-T-------------T|---T-BE?E---o---|----M-----BT---------------E--------?X---------M----o---
---------X--E------BM---M--TT------------------------MB--TMXMT-----o----E---?-|-|M--------|M-XM-------------B---------|------E--E-|o------M----E----E----M|------M----?----B---?-----------M----|-----T-
--E-?-o---M----B----M-?E---E-----E--o|------o----------o-X-X--||B--E---oE--M-E-E--B-T-----X--?------E------?----T--T--M--E---------------BE-EM--E---B---|--E--X-oo---X---XM--X-----o--XXT----B-TE----E--
-BX--E-TBX----B---B----T---X--MM----------------X--MoX--M----B----|-o---X----------XT--------------oM|----T--E-----------T------------------------T--------|E-|oE-o-?--B---|-----o---------B-o-------X--
--o---X---?---------E--E--M-T-?--|---X--MXE-------||--M-E---E---?---------------?B--------o-B-B--|o-oo-o----------T-o---------------?-o-M---E--BMM--T-----------T-E--------TE------XE--X--M------|-----v
---XE--|oT------M------------------------------M-XB---X--?---|-XME------T|B--XM------|--o-BXBT--E-----o-------B-M--X----M---------T--E------------oo-T--oM-|---E--o-X------|-----BB--------------------f
-----------B-----|-----o--|-BX--o--?------M-----M-----T-----?-BEE----------BX--------|?--------X----o-?-B----?---B---X--o---B--------------------Eo-----X--|-|--?---?---B---T--------------E--?-X---B--f
----------ET--|X--MB--X-B-?BM-B--------?-----T-E------o--------------E---------T--T?--?------X---To-o-----|?-o---------o-X-------o---o--------X?----X--E-------------------?----------o---M-XT-X-T-----f
-----M-----E-----|---o---T--------T-B------------------T--------o-X--E-?--XM-E|-BB-M-------X---M|-|-?XM-?-M-B--o-----?---E-Mo-----------------|--o-----------M-X-------|-E-B----------T-o-E--X---X-B---f
--E---B|--T-----------B--B-o---T-----------X-?----o|-T----X---E-T----|--?--------?----------EBT---|----M-oM|------|-----M-------E-----------M?-----E-B-EE--EE---o-?T-----BM----------------M-----------f
--X-----|--o---|T-----o------M-o---M-----X-E-M-----T---------|E-----oT-X---------T-o-----X--E--T------E--T-----------E-oT----|-----------------M-MMT|--X-X------------|--oE--M----EM--E---?X--X-?---X--f
m-oooT-------|----E----EX------B--------M--o--?X-E-T-----X-X----------o|-E||B--o-B----E-Bo-?-E----|--M--------E-?-----?----E-------o---o------B---X-----EX----B----o-----------|--Mo--X-BM-B--|M--T----X
XXXXXXXXXXXXXXXXXXXXXXXXXXXXXXXXXXXXXXXXXXXXXXXXXXXXXXXXXXXXXXXXXXXXXXXXoXXXXXXEXXXXXXXXXXXXXXXXXXXXXXXXXXXXXXXXXXXXXXXXXXXXXXXXXXXXXXXXXXXXXXXXXXXXXXXXXXXXXXXXXXXXXXXXXXXXXXXXXXXXXXXXXMXXXXXXXXXXXXXX
