o?-?|-TM|XT-B-MT-MBXMoTX--X--?E--T-B-o--E--B-M-EM--X--E?MT-T|o?|-XMo---o---|X?-oo-M-ooM-oTBX-EM|M?T-B----E--B-E-MTT---M-EE?Bo?Xo-EEMM-o-To-M-XM-|oTEXo-----T-X---E--|E--X-EE-ETB|-BE--TX-oTBBXT-T--?--B|
T--o---E-T-?TTM-|o-BX-EM---T-o|o-?-TX-oE-XX|-|BX?-M----TE|oBT|M?ToEX--MX---EM-?-XT-?--|----|-ME-B---B----Mo-B-E-M---T-o--?o--TE?-T-----MX-M-B--X-Bo--M-o?B-T-?---X-B-MMEX-oBM|-oE-o-E--?-Eo--T-X--T-T-EX
EB---MMXo---|TE|--TE---To|-MX-XoBB|-?B--o-?----X--M?-BB-TB?BB-MB-X-B?--oBM-?----MTE--X--X--X?XMTXo-o?----?--B-BX-X-MTo-ETEo-EE|---E--BEEM--T------EM|TET-?B-M-MBoMoE-|-E-----|-TMM-T-B-|----o-?T||E-X-EX
TTM--B-|?-BToo--|-|T-oE-|-o|--MB|E-T-X----EETo--oE---T??Bo------B-|----B-XX------||------MX|-o|-o-o-|--E-X|--T?-EoT-?---|--E|M-o-MT--B--T-||-E?--XM--?o?-oo??o|--T-|MBTE-X-TT-TTM---M---o?-T-BBXM--E---M
B?|---o--BBE-----MX|MX-XTT--BM-|TX--M-B---BM?M-o-o-X-------?B------o--??o?--?-X--T-o-oMo--M-BTE-------oX--?--B--X-MB?-o?MEM-M-MTX--E--|--o--E|-?|--o---X-XTMT-?--X-MTMoo-||MToT--|M--ME-|E-T-|MT-TB-XBE|
BB-ET-E?--o-o---o--o----ETB-XBMBM|-|-X--T-----EB-BX-EM--E------BE----X-oX-?--X-BX-|-TBM--|-E-XB--?B-X-----o--T-EB-?M---?ToTT-?---B-|BX---|EBo?E--?Xo-o-M------TBXXTEX--|-------o-BBET--oM-----M--M-T---?
E-EoMTE--|BE-M-B-X--E-B|-o|-|M-E---|?M-M-MT--?---XEMM-Eo-TB?|-B-BB-X?B-o----MB--o-?E--B-oET--?--XEB|E-|---E|ET-EE-----B|?X-----E---M-oB?-|T-BXXoEXo--o?T--B-?--T---E----T-XXoX-oo-T--|T?-BT-M----?ToET-E
o|MT?-oMEoo?---X|o-|--M---E-o---X-|M?-EB???---B-|M|X|Eo-?To-------oX||-To?-oE-B-|-B--o---X-oE?--o--?-EX-Eo|T??E|---T----oE--MB--?---|-|oT--T?--E----X-BBTT-?---X-M|---M--M---?-MB-------B-BE-M-E-oM--oTv
X--TX-o??TM-T-EX?E---o---MT----ET-T-E|--T--X?T--E-o-o|?BT---X?-?-o---XB--|-XMBE-T-ETo|-oM--B----EB-X------Eo-?E?-ToBB---E--EE--|ToEMX?--o|oM--?-o--T|-|--?T----|-?MToEo??--XB|T---?--B-B-M|-?-EB|-B-|X-T
?-?--oT-E|---|-B--B-EEoo-M-X-M-Mo|?E|o---X--X--E-o-B-EEE---|---|o-T----|M--?Tooo-E-XToBXo|oo--M-TT--BBoEB-|-T--B-----Eo-XM|T-----EEoToo-ET------M-o-BEoEXT--B|B-oooX-BBT-|-B-o-|-?E---E----|-o-?-o?oTXoM
oT--?---ToE--??---XT|oMM|XE?BE--ET-??-MM--M---?-X----TB|-E-|B--|T-EM?M-X--?-TXo---X-TX--X-||||-o-T-MEM||-X--BE--|XM|X--|-M-oMo-B--o---EXE--E---MX-?M-oBXT---M---E-MMB-|-ToT---T|oXX-o-BB|o??o--?---o-TXo
E-|oM---?-?E-BMTo-M-MoX-oX|--E|--?BEoB|o?|||?o?-?----|--BT-|-T--T|----To--M--T-?--BMB-B--X-BETTE||-o-BoT-oEMo--Bo-|------|-E-oX-E|?MX-MEoo-ET---|MBBM--E--?MX-?-EB--T--?-----BE|-|-X--XXT?|-|M--ETBM--|?
T-MB---E|--X-EX-???-M-M--o?-B?Mo-B-E--|?T-TM--BBBo-T--X-T---XEX--Xoo----BM--EM-E-B---oT-B-oo-BME?|B-T--B-?XMMT-B-?ToE-o|-oT-TB---TE-XXE---ETT-XE?-?|-B-B---MX--?BBXT-o-oT-?-T-M--T-|-E-X|-T|M|BBEX-XoT-M
|-MoB-E-M--X-------X---BTBE|-XEE--oEXTMT-X-|---TM-B-|?X-E---|?T-BBX-TB---o|E-B-|----B---T-T-M--M---o-o--MME-B---?MTT-XT-oX-BE-oT--BBB-?X?TXMMX-?B-------oo---?-X-B--?--o-----o-BB|-||--oB-XM?E-XX--TEE-o
m-------X-EBX-B|XX-M-T?EM----oM-BM-?XM?-XB|--|E-Xo-X---B---E--M-?-TE-TB-|ET---?-oB-?-BX|X|-|?|B?-|------?-?-oXT-BE|o--oX-oMX-B-B-M----?E--T-M--o--X-|E-TMT--BT-X?--|-ooB-MTBTEo-X-BET-o----?--|---?X|X-X
XXXXXXXXXXXXXXXXXXXXXXXXXXX-XXXXXXXXXXXXXXXXXXXXXXXXXXXXXXX-XXXXXXXXXXXXXXXXXXXXXXXXXXXXXXXXXXXXXXXXXXXXXXXXXXXXXXXXXXXXXXXXXXXXXXXXXXXXXXXXXXXXXXXXXXXXXXXXXXXXXXXXXXXXXXXXXXXXXXXXXXXXXXXXXXXXXXXXX-XX
