---oo--------B-----------------X--?------oE--------?---M---?-----M-------E-T--X----------E---EM--------E------X-MoM--M------------o-|X-M--o-?--?------B-----o--------B-----?------B-----?-------X-----o-
---E---T-------B---T-?----------o----------B--T-o-X------T--------o-M-o-?--B------------------------T-------B------------MM-ME------M-T-------BX--------E---T---------E--B--BE--M----T-X-Bo--B---B---M--
----Eo-X-----------?B--EB-o---o?-?-B-M-T-?----X----------B--BX-o---M---------Mo-X---?---o-M----X--M-M-T-X--MM-Bo-------M---B---------oX---?--------E-------B?----X-----------E-------?---E-?--------B---
-E-X-----------E--?EME---Mo---X-?---EM-XM---------------M-X-----MXB---M---?----------B----M-------B---|---E----?-------------------X-----------B-?-----------------T--T?-T----BX----XX---BE-------------
-T-?B---T-----X--M--o------?---B------X---TE------------X-----------TB------------?---------T--XM----XBX-------------X---------X---M-?-----Eo------?----M--------X-X--M-?B----Xo-----XM----X----M-B-----
-M------MM----BX-----M---B----E--------M--B--?---------o-----------XMBo----M-?o---M-X---E---X--------?-----------------B-----BX---B---EB--EX--MME--o-----B-----------X?-?--o------?----------B----------
-E-B-?-E-----?----------E-???--XX-----X?-----EXT--M----------o--?---o--E-----M--T-----------------B---------------------X--------------X--E-----E--------X-----------M----T----B------o-----E--Moo-M-T--
----------B------X---o---?--B-B----X-----------M--X---E-----o--o----?o---E--T-E-B-B--X----------?-B-E-?--XT----E-----------------B-B--o------o-T------T--o-?--o-BBTo--M---M-o----X-----B-------------?Tv
---X--X--T--?------M-X---M-EB-------T--------------o--Xo--?----------B-o--BoX------X--T-----o-----X---o---?-o-E-M-B--------MT-M-----E--E-T---o-M------------------?--------o----?--M--------------o-E-?f
-E-?-----M--T--------E--------E-----?-----Bo-----B------E-----------?-----X-----M--X--B--------------?M-?--?MEo-E----?---MB-?------M-?---|------Mo----E------X---------ME------MX----X---B--------B--X-f
----M-X?---?M---?-TM?-X-----?------B-oX--B--M-M----------X-B--B-------?------------M-?-E---E?--------?o--o----M-E-------?--M-M------X--X-B--------B------B-----T--X-X---------B-XT------?TX-B-MM----E--f
----------------EEBBXX--X----?M---T-o-------EE-------------------?EM--------M------E-o-?M--X--------?-----T-M-----T-----T-B--?---------o--B-------X---XXXB-----B-------?-------BM|----T-oB---Xo--E-----f
--------M----E?T-----------M---M--M-?---XE------------X-B----------X------?---M---T-E------?--o---o---T--X?-------X-----XE----------M-----------MMB--ET---Mo-M-----?-----M-----X-?-T--M--E-----BEB-----f
---X---------?TX--M--?------E----B---E------M------E-B-----o?--T--XM------X-------?-------------------B-B-----o---B------?-o----------oE--------T--E--|-------X----X-----M-------TMBB----------B-------f
m-------T--T--X-?o-------------oM-?-----------oE-To---------T--|------B---TX-M----------------------?-----------M-B------B------------T---------M-MB--?Bo--XT---E--------M-----E-|------?M---X-T-M--B--X
XXXXXXXXXXX?XXXXXXXXXXXXXXXXXXXXXXXXXXXXXXXXXXXXXXXXXXXXXXXXXXXXXXXXXXXXXXXXXXXXXXXXXXXXXXXXXXXXXXXXXXXXXXXXXXXXXXXXXXXXXXXXXXXXXXXXXXXXXXXXXXXXXXXXXXXXXXXXXXXXXXXXXXXXXXXXXXXXXXXXXXXXXXXXXXXXXXXXXXXX
