X--?-M--M-|----BME-?--?X--B?T-T|-B-M---M-EM?oT---X|E-B|?-B?--------ETET-E------MB--M----------Mo---EET-|-T-T-E------M--B-------B-|E|----B-----EMoT-X---|E-B--B-M---?--|-MB----E-BM-----E-T-E----B|o-----
o-M----M----XX|-?-?-----B--E|-XT-T--?-------B-BT--|-ET---XE-E--|-----|---?X-----|-------B--oE-TX-B----B--o-|B?B|---MX-M-ETX--M-|-o------?MMEB---E-B?----B-o-E-|-X?-B--TE---|?ME-|--B--ToM--M?---T----T-X
X?-T-B?-|To-o---------BX-----?-EE---B-----E---o---MoE--EEE-?-oBEM-M-------E??----EB-XM-o-----MoE---T----o-E-|-E-ET?-?-?----Eo-M-----oMT--?----|-----X------|B--B?||E-|-T---o?M-?-M-X--|EXB-TX----T------
B---ME-|-?---?--E-oM-?T----?-BTMM------o-oXTM---MT--|o|X------|--|BMo-?--Eo--?|--o----B--B-To?-Bo-E----o--?-E?---------?-E-----?E------?MX-T------TEX|----?------?-----Bo??BE-?-?-----M--X-?---X------MM
T-EX|-T-T-B--------E------E--TM-T--|E------|M|B|M-?MX|B-X-o-oTT-|?-?---BX---|--|---B-X|Mo---B--E-B-X|---?o-X-M-oTBMX--?-o---|TM-?XBE-E--X----||--oB---BoTT|T---T---B|-----XEXB------|MM-?-?T-----T-|BM--
XT|?B-M---T-X-|B|---XE?----T-X----BT-Xo-B-E--|-E|---B--?--?|---TT-----Eo--o-T-XET-TX---?--------?-MT-E--T-?-B-XTB----------?XME|?E-T---o-X--?--E-M-|-----|--?X--EE--M--|T--XXo-B--T-X--------B--B--o---B
X--o---Bo-|-M|o----?oB--T-----MXT-MX--------MMX|X--XMo----M|-?-BTX|-E----|MET?--E---X-X--|o-E--o???-B?-BB----o-?-Eo-B-oT?-TXX----B---|T-----?--M?M--o-E-T-T-T----EX?-E-E--?-X-----BX------X--M|------o-o
MB|--|TM-X-M---B-M-EMMBE-X-?E-E-?oX-XT-|------oM|?BM--?M-T---o--|--?-M---M-oo--B-oT--MB|-M-----MoE|BE------XMM-E-M-----T--o-|-|---BB?----|?--BXo-|-|--|--o|-X--ME?------M-------|-BE-------MB-XBXo--M-Ev
o---|-----Bo?B--|----E-EM-M----T-X|E-oEB---|--?---MEE--XB-T-EBTX------B--B----E-M--|oo---|?---|XEMT--??-ME--B--o---E-|----o-o--B|EM-B--X?-----?-M----XMX-||----M-X-T---X--Bo---B-MX---|-|--o---BB-----BM
X-o--E---X?---TB-----------Eo------------?-----|-|X?Mo-B---oXXE--M-|BE----|---T--M----o-?|--BoBoTEX--?T?--T---MMo--X|--|----B-------T----o--X------E-|B?EBM-||B-EB|-B---T----X--T--|M--X|B---TBE---oE?T?
B---T-----XX?--|T----oTo-|--M?--E-XXTo--T-o-M-BEB-------T-E|-M-o|?----?--B-|--?---|-o-MB--BX--E------?|B?---M-B--T--?-BoM-|-----|T|E--o----X------T---E|?o|-||-M-|XBT---Eo--M---E-T-?--T-X-E--B------|?E
o-T---B|-|XX--oTEX-----EBoMXX-ET---B-o-----oX?-o----E-M--EooE---------?--E-X-X-ToM-E--|TM-----E-|M----T-----BE-M-E-o---X--X-EE-?BM|E--?T-----T|-EM|M---?-XTE?-|--oM?EXM--o-E-B--E-BM-----XM?T?---E--B??B
Mo|-M--MB-----|-B|T?--TE--TXM-M--B-T-o---T-----E-|-X-?-BTM-TE-T-?ET--T-B?--?TEB-|-B-?TM--T--oM-M?--TMT-E----T---B----ME----T-T-M-X---M--MB-MoE-----------?-----E-MXo--T----|?---|--B-X-XB-X----X-----??X
BX-Eo|T?BT----X--|T--|-?o-?T-----Xo--XET|T-B--E-BX---M-EX--?B-B?-X--M---B--TB-M-----o-M-M----BE-?EB----|-EX?--X-----X-o-T--|E-|-o---o|B-oM-----MB-o--T?M---|-?-X---M----oM--o|-T?B-?--?---|B---XE-----oE
m--BX|o--oE--XBMEB?-?-B---?-X?-oBo-oM---XE|?o-B?E--o----|E-T--Mo--B------T?BB?--?-X|TB-oM-M--??X--BTB-T-o---|X-M|BM-|----BM-BB------?T|M-|----B--B---X-T|----TE-X||--X-E--E-o-B-T?-X-B--|E-M--?B---TBBoM
XXXXXXXXXXXXXXXXXXXXXXXXXXXXEXXXXXXXXXXXXXXXXXXXXXXXXXXXXXXXXXXXXXXXXXXXXXXXXXXXXXXXXXXXXXXXXXXXXXXXXXXXX-XXXXXXXXXXXXXXXXXXXXXXXXXXXXXXXXXXXXXXXXXXX-XXXXXXXXXXXXXXXXXXXXXXXXXXXXXXXXXXXXXXXXXXXXXXXXXX
