---E----------------X--------------------------X-----------------E-T-----------E----o-------------E-X?------------E-B------E----------------?------oo-E-B------------------E----------?-B-?----o---?----
----B--M----------E-------o-?X---------X-----------E---------------?--------B--?-----------------o-----B----------B-B-----M--o-?---------oE---M--------oX--------------------E-------?o-------E--?------
--------------B-----E---X---------------------?B----o---------o----------------E--------M---------------oB?---o----M-----------M-------------------o-------o------X-----------------E----M--------o-?---
--M-----------------T---B---o----------------------------X---X-----?--oo---------B-M--BE?E?E-X-----------M--?---------??----------B---------X--X-----T?--o-----------o-------------------------T------o-
---??----------B----M-------o----X----------------------B-?-------E---Xo--M-----E---M----M------?--------------B---------------T--E----o---o-------o-X--o---?----E-----------------------------?--------
------EE--?--X----------------------------------------------------------------?--------B------------X-E------------B-B--------??---B--??--------M------?-------XX--M----?---X-----X-B--E------M-E-------
--------------------------Bo----?----?---------X--E---B-----------?------------E---E---------o-----E--------X----------E-E--BX--X--o----o----E----o----------M------MB--------o-----M---X----ET-------M-
----------B-------M---?-X--T-------X---------------------------------o----X-------------------M------------------o-----E-------E-------o-o------E---------X-M----------------o-----E---------?B--------v
-E----------------o--------M-----------oo-MM-------------o---oo---------E-----M-E---------------?----?---------------------E-----------?---o-------?-------------EM---------------?-------------------Ef
-----------?-----M--?-----o-------?o-o------------BE--E---X--X-------------------------M----------BB-B--------o----------------B--o---o-------B-o------------------------?--B?---------------MX--------f
--------------E--------------------------------------------------------?--B-M---M------?-MBT---------------B-EE-----------------------------E------------B---------B-M--?-o------------------X-----X---f
----------X--o-----o------------M----E--?---EE-----E--MoB---------------E---X----B--------XM-----?-----------------X----------------------------X-E---X?--------Eo---E----M--------M---T-B------------Ef
------------E-E----------E-----?------E------------B---------?------Eo---o----E-----M---B---------E------M------------E---E--E-B-----------E--X--B-----------------E----o------------B-B---------------f
----X------------------E------------B------------------?----B------------------E-T-----X------TXX---?---X--X------------T-?------------M------E-?--------o-----------B-------ET---------B-----Bo---EM--f
m-E-------X------T-----------o----------------E--------B-E-X------------M--------ME----E------?-X---T-M-o-T--?----------|-----------E-----?---?----o-oM---X-----------TB------X---------X--T-?-----X?--X
XXXXX-XXXXXXXXXXXX-XXXXXXXXXXXXXXXXXXXXXXXX-XXX-XXXXXXX-XX-XX-XXXXXXXXXXXXXXXXXXXXXXXXXXXXXXXXXXXXXXXXXXXXXXXXXXXXXXXXXXXXXXXX-XXX--XXXXXXXXXXXXXXXXXX-XXXXXXXXXXXXXXXXXXXXXXXXXXXXXX-XXXXXXXXX-XXXXXXXX
