--o------------o-----T---B-o-|B-M---E--------|----------o--------M--------------|T-----------?-X-----o--T---------o-B-?-EXE-----T------M----M-----MT--T----|-B-M----o--o-------o--o-Xo-B--M?----------M-
------------E-----------M-----|o-X---T--o----M-----------------------M------?TE-M--BT----------------------M---------XT-------------EB--X----X---?---?---------M---------?------E--?-?----M--?o--|-oT---
-----B--?-|-------------oEE----------------|---T----|-------BX--X-?-MBM--BMB--|-X---?------?------ET------M----?----E------E-|-----B--X-X----X----E--o---|TM--M-B-------------B-ET-----E-E--X-----------
-----------T-E----?---M----T----o----|--------------BB---------B----o---?-T----------?o----------M-B-MT|X-?E-oM---?---X----M-------?---?------------|--M-----------M----o--Xo---M-------EX-|----E-------
----B----B----|------|-EE|B--------XMT--------B--T----?--B|---E---?-MM-----------------o-MB--?XoM--------------------|---M-----T------BX--------?-----X-----------EX----------------?-----------E--oT---
----------------|-M-X--|?--------o---E---|--BM----B------X?------XB----------|--------o--?---|-----?------M---|--X-------E--?----M-|-----E---o--M----------E-------|--E--B-E-M-T--------M----o------T??-
--oT----X--T------??B--------E----?o-----T----X--o----E-E------|EX----?---M-----XM-X-|------T--?XX--------o-T---T-------|-E---------------X----------|-E-----T--X-------Eo-------T---o---------o-B---oo-
-----E--|---------E-T--B-oE------M-------oT------o-------------------TB---X--------------XX--B-----oM----X|-o?--X-X-M--E-o--o----M-EoE-?-------------B----?o--------M----?---|---o-|---E---MTM---X-----v
-----E---o-o--T--M--oTM---o------T--BoE----|---------E-|---E--|-EM---B---|----------------X---|---|---X-?----X--------|-----------T-----o--?-E|-----------M--o------E-------M------------T-----?---E---f
---M-----------X-E-------------?T--E-----B-------|E-X----M--X-E---?---?-------M-|XE--------E--?X---?--M--T-o?-?-o-----o--T-|--X---oT---X-M------T---X----|----T-o-----o-----M----o-o----M-EX-----------f
-B-X------T----X------------X----?-?--B|----o---------BM----M-------X--M--------|---EE--TX---ME-----M---?-----------X-X-?T---|--T-------E---o---|-E-------------X-M--MXE-----E-------o--T--------------f
-?---o---?-----E--------X--|-----------T------o----o---MX-E-E---Eo-----|--------?-?-----M|-o---|B-TB--o?----?--|--B------|o---X--BB---------M-----E-EE------------------E?--M----BEo---?----X|-----BX|-f
-o------M------ET--T-----o-E-XBT--B-|-X--X--|--X------B-T-----------|-ME--E--M-|--oT--B--E-X----------|---Eo--E------?---o----------------o-------B-----o-------------|B----|X------o?---o---|----o---Bf
--------XT-M--To--M--T----B--o----X--------T-B---oT-----|-M--E-----------------o----E---------------E----?---B-oEM-----o----|-BB---|--E--?--M-X?TM-----E----E---------M|-------?-?-----E---------o-X---f
m------T?---|B?o|M---|---o---------------B------X-----------------?--o--o--------M?---T--o-----------X----o-?--------?--------BX-MM---------o-?MX-?-?-|-?-|----|---MB---?o--B--?-o-----------------|---X
XXXXXXX?XXXXXXXXXXXXXXXXXXXXXXXXXXXXXXXXXXXXXXXXXXXXXXXXXXXXXXXXXXXXXXXXXXXXXXXXXXXXXXXXXXXXXXXXXXXXXXXXXXXBXXXXXXXXXXXXXXXXXXXXXXXXXXXXXXXXXXXXXXXXXXXXXXXXXXXXXXXXXXXXXXXXXXXXXXXXXXXXXXXXXXXXXXXXXXXX
